route,route_starting_time,percentage_of_compulsory_stops,benefit,walking_distance,num_segments,compulsory_stops,requests,number_optional_stops,used_nodes,unused_nodes,unserved_requests,served_requests,opt_stops_visited,opt_stops_not_visited,total_used-travel_time,travel_distance,build_time,solve_time,optimality_gap,objective_value
55,18:56:00,0.4,1000,0,11,12,2,2,12,2,2,0,0,2,6900.0,14581.851999999999,0.006616830825805664,0.0014808177947998047,0.0,-14581.851999999999
55,18:56:00,0.4,1000,100,11,12,7,5,15,2,2,5,3,2,6900.0,16011.169000000002,0.0008671283721923828,0.0009951591491699219,0.0,-11011.169000000002
55,18:56:00,0.4,1000,200,11,12,16,12,18,6,6,10,6,6,6030.0,17212.013000000003,0.003182649612426758,0.003362894058227539,0.0,-7212.013000000003
55,18:56:00,0.4,1000,300,11,12,51,23,21,14,38,13,9,14,6900.0,17529.972999999998,0.016171932220458984,0.06155896186828613,0.0,-4529.972999999998
55,18:56:00,0.4,1000,400,11,12,55,26,24,14,39,16,12,14,6900.0,19107.957,0.021404027938842773,0.0697929859161377,0.0,-3107.9569999999985
55,18:56:00,0.4,1000,500,11,12,58,27,26,13,40,18,14,13,6155.552098246233,19616.340999999997,0.022186994552612305,0.07061409950256348,0.0,-1616.3409999999967
55,18:56:00,0.4,1000,600,11,12,58,27,26,13,40,18,14,13,6155.552098246233,19616.340999999997,0.03956890106201172,0.0706021785736084,0.0,-1616.3409999999967
55,18:56:00,0.4,1000,700,11,12,58,27,26,13,40,18,14,13,6155.552098246233,19616.340999999997,0.022612333297729492,0.07033991813659668,0.0,-1616.3409999999967
195,07:09:00,0.4,1000,0,9,10,2,2,12,0,0,2,2,0,3557.0,7841.07,0.0005431175231933594,0.0005459785461425781,0.0,-5841.07
195,07:09:00,0.4,1000,100,9,10,22,7,17,0,0,22,7,0,3283.0,9540.228,0.0018360614776611328,0.001268148422241211,0.0,12459.772
195,07:09:00,0.4,1000,200,9,10,37,12,22,0,0,37,12,0,3459.7123971009314,11417.908,0.0042438507080078125,0.0016150474548339844,0.0,25582.092
195,07:09:00,0.4,1000,300,9,10,47,20,24,6,7,40,14,6,3557.0,12948.919999999998,0.008089065551757812,0.004642963409423828,0.0,27051.08
195,07:09:00,0.4,1000,400,9,10,48,21,24,7,8,40,14,7,3557.0,12948.919999999998,0.00875711441040039,0.0045299530029296875,0.0,27051.08
195,07:09:00,0.4,1000,500,9,10,48,21,24,7,8,40,14,7,3557.0,12948.919999999998,0.009112119674682617,0.0046460628509521484,0.0,27051.08
195,07:09:00,0.4,1000,600,9,10,48,21,24,7,8,40,14,7,3557.0,12948.919999999998,0.009072065353393555,0.004364967346191406,0.0,27051.08
195,07:09:00,0.4,1000,700,9,10,48,21,24,7,8,40,14,7,3557.0,12948.919999999998,0.00892329216003418,0.004297018051147461,0.0,27051.08
196,16:23:30,0.4,1000,0,6,7,6,3,9,1,1,5,2,1,2893.0,6780.105,0.0005109310150146484,0.0007131099700927734,0.0,-1780.1049999999996
196,16:23:30,0.4,1000,100,6,7,17,9,11,5,6,11,4,5,2330.0,8427.657,0.0018978118896484375,0.022099018096923828,0.0,2572.3430000000008
196,16:23:30,0.4,1000,200,6,7,23,13,12,8,11,12,5,8,2893.0,8353.595,0.004088878631591797,0.03406691551208496,0.0,3646.4050000000007
196,16:23:30,0.4,1000,300,6,7,28,13,12,8,13,15,5,8,2893.0,8353.595,0.00481414794921875,0.02965688705444336,0.0,6646.405000000001
196,16:23:30,0.4,1000,400,6,7,29,14,12,9,14,15,5,9,2893.0,8353.595,0.004945039749145508,0.0414729118347168,0.0,6646.405000000001
196,16:23:30,0.4,1000,500,6,7,29,14,12,9,14,15,5,9,2893.0,8353.595,0.0051670074462890625,0.04450201988220215,0.0,6646.405000000001
196,16:23:30,0.4,1000,600,6,7,29,14,12,9,14,15,5,9,2893.0,8353.595,0.0049707889556884766,0.04322385787963867,0.0,6646.405000000001
196,16:23:30,0.4,1000,700,6,7,29,14,12,9,14,15,5,9,2893.0,8353.595,0.005010843276977539,0.04212594032287598,0.0,6646.405000000001
199,16:04:00,0,1000,0,1,2,0,0,2,0,0,0,0,0,3491.0,5573.648,0.00013113021850585938,0.000331878662109375,0.0,-5573.648
199,16:04:00,0,1000,100,1,2,6,6,7,1,1,5,5,1,2473.02433786686,9476.064,0.0008480548858642578,0.0009288787841796875,0.0,-4476.064
199,16:04:00,0,1000,200,1,2,16,18,20,0,0,16,18,0,3386.324117155811,12975.620000000003,0.010050058364868164,0.0026879310607910156,0.0,3024.3799999999974
199,16:04:00,0,1000,300,1,2,25,24,24,2,1,24,22,2,3467.6622151634438,13287.288999999997,0.025802135467529297,0.011016130447387695,0.0,10712.711000000003
199,16:04:00,0,1000,400,1,2,27,24,24,2,1,26,22,2,3467.6622151634438,13287.288999999999,0.02542281150817871,0.010469913482666016,0.0,12712.711000000001
199,16:04:00,0,1000,500,1,2,27,24,24,2,1,26,22,2,3467.6622151634438,13287.288999999999,0.026203155517578125,0.011158943176269531,0.0,12712.711000000001
199,16:04:00,0,1000,600,1,2,43,25,24,3,2,41,22,3,3467.6622151634438,13287.288999999999,0.06061387062072754,0.012293815612792969,0.0,27712.711000000003
199,16:04:00,0,1000,700,1,2,43,25,24,3,2,41,22,3,3467.6622151634438,13287.288999999999,0.042684078216552734,0.013252973556518555,0.0,27712.711000000003
192,14:50:30,0.2,1000,0,3,4,5,3,7,0,0,5,3,0,2378.0,6520.6269999999995,0.0003981590270996094,0.0005810260772705078,0.0,-1520.6269999999995
192,14:50:30,0.2,1000,100,3,4,25,12,16,0,0,25,12,0,2499.7572103913117,8886.414999999999,0.0036821365356445312,0.0011250972747802734,0.0,16113.585000000001
192,14:50:30,0.2,1000,200,3,4,46,16,20,0,0,46,16,0,3108.0,9589.883999999998,0.009535789489746094,0.009343147277832031,0.0,36410.116
192,14:50:30,0.2,1000,300,3,4,53,21,23,2,2,51,19,2,3108.0,10855.734999999999,0.01993870735168457,0.039114952087402344,0.0,40144.265
192,14:50:30,0.2,1000,400,3,4,53,21,23,2,2,51,19,2,3108.0,10855.734999999999,0.02053976058959961,0.041146039962768555,0.0,40144.265
192,14:50:30,0.2,1000,500,3,4,53,21,23,2,2,51,19,2,3108.0,10855.734999999999,0.020107030868530273,0.03921008110046387,0.0,40144.265
192,14:50:30,0.2,1000,600,3,4,53,21,23,2,2,51,19,2,3108.0,10855.734999999999,0.020570993423461914,0.042679786682128906,0.0,40144.265
192,14:50:30,0.2,1000,700,3,4,53,21,23,2,2,51,19,2,3108.0,10855.734999999999,0.02081918716430664,0.04132509231567383,0.0,40144.265
195,07:09:00,1,1000,0,22,23,3,0,23,0,0,3,0,0,4214.0,9212.719,0.0010769367218017578,0.0003910064697265625,0.0,-6212.718999999999
195,07:09:00,1,1000,100,22,23,24,2,25,0,0,24,2,0,4013.5857193987104,10226.926,0.002332925796508789,0.0007078647613525391,0.0,13773.074
195,07:09:00,1,1000,200,22,23,40,6,29,0,0,40,6,0,4201.656958363161,11736.784,0.004127979278564453,0.0011000633239746094,0.0,28263.216
195,07:09:00,1,1000,300,22,23,47,11,29,5,5,42,6,5,4201.656958363161,11736.784,0.00540614128112793,0.0012140274047851562,0.0,30263.216
195,07:09:00,1,1000,400,22,23,48,12,29,6,6,42,6,6,4214.0,11736.784,0.005810976028442383,0.002210855484008789,0.0,30263.216
195,07:09:00,1,1000,500,22,23,48,12,29,6,6,42,6,6,4214.0,11736.784,0.006796836853027344,0.00238800048828125,0.0,30263.216
195,07:09:00,1,1000,600,22,23,48,12,29,6,6,42,6,6,4214.0,11736.784,0.005856990814208984,0.0025658607482910156,0.0,30263.216
195,07:09:00,1,1000,700,22,23,48,12,29,6,6,42,6,6,4214.0,11736.784,0.005799055099487305,0.0023081302642822266,0.0,30263.216
196,09:57:30,0.4,1000,0,6,7,1,1,8,0,0,1,1,0,2791.0,7036.397000000001,0.00028395652770996094,0.0004200935363769531,0.0,-6036.397000000001
196,09:57:30,0.4,1000,100,6,7,5,4,11,0,0,5,4,0,2791.0,9337.890000000001,0.0005147457122802734,0.0005669593811035156,0.0,-4337.890000000001
196,09:57:30,0.4,1000,200,6,7,6,5,12,0,0,6,5,0,2791.0,9795.826000000001,0.0006189346313476562,0.0011620521545410156,0.0,-3795.826000000001
196,09:57:30,0.4,1000,300,6,7,15,9,14,2,3,12,7,2,2791.0,9795.826,0.001544952392578125,0.028627872467041016,0.0,2204.174000000001
196,09:57:30,0.4,1000,400,6,7,15,9,14,2,3,12,7,2,2791.0,9795.826,0.0016031265258789062,0.02692890167236328,0.0,2204.174000000001
196,09:57:30,0.4,1000,500,6,7,15,9,14,2,3,12,7,2,2791.0,9795.826,0.023382902145385742,0.026955842971801758,0.0,2204.174000000001
196,09:57:30,0.4,1000,600,6,7,15,9,14,2,3,12,7,2,2791.0,9795.826,0.001773834228515625,0.026172876358032227,0.0,2204.174000000001
196,09:57:30,0.4,1000,700,6,7,15,9,14,2,3,12,7,2,2791.0,9795.826,0.0015082359313964844,0.02780008316040039,0.0,2204.174000000001
155,07:44:30,0.2,1000,0,2,3,6,6,5,4,5,1,2,4,1489.8581782390866,5708.795999999999,0.0006890296936035156,0.001116037368774414,0.0,-4708.795999999999
155,07:44:30,0.2,1000,100,2,3,14,13,5,11,13,1,2,11,1365.0,5085.363000000001,0.003332853317260742,0.003178119659423828,0.0,-4085.363000000001
155,07:44:30,0.2,1000,200,2,3,40,21,12,12,31,9,9,12,1861.8435710450976,6878.033,0.015626192092895508,0.013226032257080078,0.0,2121.9669999999996
155,07:44:30,0.2,1000,300,2,3,45,24,12,15,35,10,9,15,1795.0008574922467,6878.033,0.023602008819580078,0.015340089797973633,0.0,3121.9669999999996
155,07:44:30,0.2,1000,400,2,3,45,24,12,15,35,10,9,15,1795.0008574922467,6878.033,0.023273229598999023,0.017177104949951172,0.0,3121.9669999999996
155,07:44:30,0.2,1000,500,2,3,45,24,12,15,35,10,9,15,1795.0008574922467,6878.033,0.023034095764160156,0.015598058700561523,0.0,3121.9669999999996
155,07:44:30,0.2,1000,600,2,3,45,24,12,15,35,10,9,15,1795.0008574922467,6878.033,0.023062944412231445,0.015413999557495117,0.0,3121.9669999999996
155,07:44:30,0.2,1000,700,2,3,45,24,12,15,35,10,9,15,1795.0008574922467,6878.033,0.023650646209716797,0.016716957092285156,0.0,3121.9669999999996
55,15:58:00,0.4,1000,0,9,10,10,6,13,3,2,8,3,3,3861.0,11868.333999999999,0.0015881061553955078,0.0016040802001953125,0.0,-3868.333999999999
55,15:58:00,0.4,1000,100,9,10,24,13,18,5,4,20,8,5,4057.943703769968,13122.076999999997,0.0030701160430908203,0.002363920211791992,0.0,6877.9230000000025
55,15:58:00,0.4,1000,200,9,10,49,23,28,5,5,44,18,5,4200.538654258831,16095.503999999999,0.00952911376953125,0.015424966812133789,0.0,27904.496
55,15:58:00,0.4,1000,300,9,10,65,28,30,8,13,52,20,8,4390.138846635644,16644.606,0.016793251037597656,0.04882383346557617,0.0,35355.394
55,15:58:00,0.4,1000,400,9,10,70,28,30,8,16,54,20,8,4390.138846635644,16644.606,0.01718592643737793,0.04331088066101074,0.0,37355.394
55,15:58:00,0.4,1000,500,9,10,71,28,30,8,17,54,20,8,4390.138846635644,16644.606,0.017796039581298828,0.04632997512817383,0.0,37355.394
55,15:58:00,0.4,1000,600,9,10,71,28,30,8,17,54,20,8,4390.138846635644,16644.606,0.017705917358398438,0.0437312126159668,0.0,37355.394
55,15:58:00,0.4,1000,700,9,10,71,28,30,8,17,54,20,8,4390.138846635644,16644.606,0.01881885528564453,0.04562211036682129,0.0,37355.394
196,16:23:30,0.2,1000,0,3,4,6,3,6,1,1,5,2,1,2557.0,6577.477999999999,0.00047206878662109375,0.00045418739318847656,0.0,-1577.4779999999992
196,16:23:30,0.2,1000,100,3,4,15,9,12,1,1,14,8,1,2557.0,8678.192000000001,0.0018651485443115234,0.012701988220214844,0.0,5321.807999999999
196,16:23:30,0.2,1000,200,3,4,21,14,14,4,4,17,10,4,2557.0,9044.026999999998,0.003963947296142578,0.05471396446228027,0.0,7955.973000000002
196,16:23:30,0.2,1000,300,3,4,28,15,15,4,4,24,11,4,2557.0,9176.690000000002,0.005410909652709961,0.036195993423461914,0.0,14823.309999999998
196,16:23:30,0.2,1000,400,3,4,29,16,16,4,4,25,12,4,2557.0,9581.375,0.0061609745025634766,0.011613130569458008,0.0,15418.625
196,16:23:30,0.2,1000,500,3,4,29,16,16,4,4,25,12,4,2557.0,9581.375,0.006327152252197266,0.01188802719116211,0.0,15418.625
196,16:23:30,0.2,1000,600,3,4,29,16,16,4,4,25,12,4,2557.0,9581.375,0.006181955337524414,0.01165318489074707,0.0,15418.625
196,16:23:30,0.2,1000,700,3,4,29,16,16,4,4,25,12,4,2557.0,9581.375,0.006544828414916992,0.012572050094604492,0.0,15418.625
195,07:09:00,0,1000,0,1,2,2,3,2,3,2,0,0,3,2615.0,4176.066000000001,0.0002918243408203125,0.0005619525909423828,0.0,-4176.066000000001
195,07:09:00,0,1000,100,1,2,20,12,14,0,0,20,12,0,2451.136289071819,9392.194,0.02611994743347168,0.003242969512939453,0.0,10607.806
195,07:09:00,0,1000,200,1,2,32,19,18,3,2,30,16,3,2615.0,9761.450999999997,0.019336938858032227,0.013118982315063477,0.0,20238.549
195,07:09:00,0,1000,300,1,2,47,28,21,9,9,38,19,9,2615.0,9980.453,0.05823469161987305,0.10052084922790527,0.0,28019.547
195,07:09:00,0,1000,400,1,2,48,29,21,10,10,38,19,10,2615.0,9980.453,0.0636911392211914,0.14192914962768555,0.0,28019.547
195,07:09:00,0,1000,500,1,2,48,29,21,10,10,38,19,10,2615.0,9980.453,0.06378698348999023,0.14181303977966309,0.0,28019.547
195,07:09:00,0,1000,600,1,2,48,29,21,10,10,38,19,10,2615.0,9980.453,0.06345796585083008,0.14267992973327637,0.0,28019.547
195,07:09:00,0,1000,700,1,2,48,29,21,10,10,38,19,10,2615.0,9980.453,0.06353592872619629,0.14204716682434082,0.0,28019.547
199,16:04:00,1,1000,0,19,20,13,1,21,0,0,13,1,0,5107.0,11329.088999999998,0.001352071762084961,0.0004360675811767578,0.0,1670.9110000000019
199,16:04:00,1,1000,100,19,20,32,5,23,2,2,30,3,2,5028.4474841923075,12289.922999999997,0.0028171539306640625,0.0008280277252197266,0.0,17710.077000000005
199,16:04:00,1,1000,200,19,20,36,7,24,3,3,33,4,3,5004.922855523735,12494.569999999998,0.0036437511444091797,0.0009539127349853516,0.0,20505.43
199,16:04:00,1,1000,300,19,20,43,8,25,3,3,40,5,3,5004.922855523735,12731.883999999996,0.004171133041381836,0.0010759830474853516,0.0,27268.116
199,16:04:00,1,1000,400,19,20,43,8,25,3,3,40,5,3,5004.922855523735,12731.883999999996,0.0040760040283203125,0.0009789466857910156,0.0,27268.116
199,16:04:00,1,1000,500,19,20,43,8,25,3,3,40,5,3,5004.922855523735,12731.883999999996,0.004003047943115234,0.0009038448333740234,0.0,27268.116
199,16:04:00,1,1000,600,19,20,43,8,25,3,3,40,5,3,5004.922855523735,12731.883999999996,0.003899097442626953,0.0009109973907470703,0.0,27268.116
199,16:04:00,1,1000,700,19,20,43,8,25,3,3,40,5,3,5004.922855523735,12731.883999999996,0.00419306755065918,0.0011157989501953125,0.0,27268.116
55,18:56:00,0.2,1000,0,5,6,3,5,7,4,3,0,1,4,6490.0,12126.927000000001,0.0005509853363037109,0.0005409717559814453,0.0,-12126.927000000001
55,18:56:00,0.2,1000,100,5,6,4,6,8,4,3,1,2,4,4267.0,12181.194000000001,0.0006461143493652344,0.0006318092346191406,0.0,-11181.194000000001
55,18:56:00,0.2,1000,200,5,6,18,17,15,8,10,8,9,8,4602.3637929491815,13602.313000000004,0.005666017532348633,0.0030431747436523438,0.0,-5602.313000000004
55,18:56:00,0.2,1000,300,5,6,51,27,16,17,40,11,10,17,6490.0,14406.556000000004,0.023152828216552734,0.0837700366973877,0.0,-3406.556000000004
55,18:56:00,0.2,1000,400,5,6,54,29,18,17,42,12,12,17,6490.0,14798.337000000003,0.028700828552246094,0.15602397918701172,0.0,-2798.337000000003
55,18:56:00,0.2,1000,500,5,6,58,31,18,19,46,12,12,19,6490.0,14627.29,0.03129386901855469,0.157958984375,0.0,-2627.290000000001
55,18:56:00,0.2,1000,600,5,6,58,31,18,19,46,12,12,19,6490.0,14627.29,0.032063961029052734,0.15840411186218262,0.0,-2627.290000000001
55,18:56:00,0.2,1000,700,5,6,58,31,18,19,46,12,12,19,6490.0,14627.29,0.032048940658569336,0.15955805778503418,0.0,-2627.290000000001
195,07:09:00,0.2,1000,0,4,5,3,3,5,3,3,0,0,3,3168.0,6398.221,0.0003662109375,0.00044608116149902344,0.0,-6398.221
195,07:09:00,0.2,1000,100,4,5,19,9,7,7,15,4,2,7,3168.0,7252.814,0.002223968505859375,0.018329858779907227,0.0,-3252.8140000000003
195,07:09:00,0.2,1000,200,4,5,32,16,11,10,22,10,6,10,3168.0,8473.479000000001,0.006505250930786133,0.09550189971923828,0.0,1526.5209999999988
195,07:09:00,0.2,1000,300,4,5,47,25,15,15,30,17,10,15,3168.0,9976.908,0.017960309982299805,0.07530999183654785,0.0,7023.092000000001
195,07:09:00,0.2,1000,400,4,5,48,26,15,16,31,17,10,16,3168.0,9976.908,0.018374204635620117,0.05909585952758789,0.0,7023.092000000001
195,07:09:00,0.2,1000,500,4,5,48,26,15,16,31,17,10,16,3168.0,9976.908,0.01910114288330078,0.060667991638183594,0.0,7023.092000000001
195,07:09:00,0.2,1000,600,4,5,48,26,15,16,31,17,10,16,3168.0,9976.908,0.018368959426879883,0.05896592140197754,0.0,7023.092000000001
195,07:09:00,0.2,1000,700,4,5,48,26,15,16,31,17,10,16,3168.0,9976.908,0.0188291072845459,0.06155800819396973,0.0,7023.092000000001
196,09:57:30,0.2,1000,0,3,4,1,1,5,0,0,1,1,0,2252.0,6068.349,0.00020503997802734375,0.0004470348358154297,0.0,-5068.349
196,09:57:30,0.2,1000,100,3,4,5,5,9,0,0,5,5,0,2348.421886184682,8195.719000000001,0.00047206878662109375,0.0005741119384765625,0.0,-3195.719000000001
196,09:57:30,0.2,1000,200,3,4,6,6,10,0,0,6,6,0,2348.421886184682,8653.655,0.0005738735198974609,0.0005381107330322266,0.0,-2653.6550000000007
196,09:57:30,0.2,1000,300,3,4,15,10,14,0,0,15,10,0,2348.421886184682,8676.52,0.0017118453979492188,0.0007481575012207031,0.0,6323.48
196,09:57:30,0.2,1000,400,3,4,15,10,14,0,0,15,10,0,2348.421886184682,8676.52,0.0019240379333496094,0.0009729862213134766,0.0,6323.48
196,09:57:30,0.2,1000,500,3,4,15,10,14,0,0,15,10,0,2348.421886184682,8676.52,0.001750946044921875,0.0008919239044189453,0.0,6323.48
196,09:57:30,0.2,1000,600,3,4,15,10,14,0,0,15,10,0,2348.421886184682,8676.52,0.0016760826110839844,0.0008831024169921875,0.0,6323.48
196,09:57:30,0.2,1000,700,3,4,15,10,14,0,0,15,10,0,2348.421886184682,8676.52,0.0017609596252441406,0.0008718967437744141,0.0,6323.48
155,07:44:30,0.4,1000,0,5,6,8,6,7,5,8,0,1,5,2946.0,5133.155000000001,0.0011720657348632812,0.0007147789001464844,0.0,-5133.155000000001
155,07:44:30,0.4,1000,100,5,6,14,11,8,9,13,1,2,9,1625.5194538892865,5411.928,0.001962900161743164,0.0011301040649414062,0.0,-4411.928
155,07:44:30,0.4,1000,200,5,6,40,17,12,11,30,10,6,11,1683.2447133738933,5633.118,0.008755922317504883,0.0019769668579101562,0.0,4366.882
155,07:44:30,0.4,1000,300,5,6,45,20,12,14,34,11,6,14,1789.2447133738933,5633.118,0.013020992279052734,0.004029989242553711,0.0,5366.882
155,07:44:30,0.4,1000,400,5,6,45,20,12,14,34,11,6,14,1789.2447133738933,5633.118,0.01407480239868164,0.005978107452392578,0.0,5366.882
155,07:44:30,0.4,1000,500,5,6,45,20,12,14,34,11,6,14,1789.2447133738933,5633.118,0.013705968856811523,0.00444793701171875,0.0,5366.882
155,07:44:30,0.4,1000,600,5,6,45,20,12,14,34,11,6,14,1789.2447133738933,5633.118,0.013417959213256836,0.004428863525390625,0.0,5366.882
155,07:44:30,0.4,1000,700,5,6,45,20,12,14,34,11,6,14,1789.2447133738933,5633.118,0.01338815689086914,0.00397181510925293,0.0,5366.882
55,15:58:00,0.2,1000,0,4,5,8,8,9,4,2,6,4,4,3756.0,10436.537,0.0008130073547363281,0.0010421276092529297,0.0,-4436.537
55,15:58:00,0.2,1000,100,4,5,20,16,17,4,5,15,12,4,3756.0,12546.912000000002,0.0040471553802490234,0.0034160614013671875,0.0,2453.087999999999
55,15:58:00,0.2,1000,200,4,5,45,26,21,10,13,32,16,10,3756.0,13344.788,0.01763296127319336,0.029807090759277344,0.0,18655.212
55,15:58:00,0.2,1000,300,4,5,61,31,26,10,14,47,21,10,4545.090223097111,17213.758,0.031774282455444336,0.028957128524780273,0.0,29786.242
55,15:58:00,0.2,1000,400,4,5,70,31,26,10,15,55,21,10,5282.0,17213.758,0.03611898422241211,0.026237010955810547,0.0,37786.242
55,15:58:00,0.2,1000,500,4,5,71,31,26,10,16,55,21,10,5282.0,17213.758,0.03687620162963867,0.04510211944580078,0.0,37786.242
55,15:58:00,0.2,1000,600,4,5,71,31,26,10,16,55,21,10,5282.0,17213.758,0.036572933197021484,0.04348897933959961,0.0,37786.242
55,15:58:00,0.2,1000,700,4,5,71,31,26,10,16,55,21,10,5282.0,17213.758,0.03770899772644043,0.04501605033874512,0.0,37786.242
192,14:50:30,0.4,1000,0,6,7,8,2,8,1,1,7,1,1,3236.0,6940.8139999999985,0.0005059242248535156,0.00047278404235839844,0.0,59.18600000000151
192,14:50:30,0.4,1000,100,6,7,25,9,15,1,1,24,8,1,2874.0,9209.721,0.0022430419921875,0.0023360252380371094,0.0,14790.279
192,14:50:30,0.4,1000,200,6,7,46,13,18,2,2,44,11,2,2961.9475363874953,9309.521999999999,0.005641937255859375,0.002529144287109375,0.0,34690.478
192,14:50:30,0.4,1000,300,6,7,53,18,20,5,5,48,13,5,3092.491857551897,9809.738,0.00984501838684082,0.005898952484130859,0.0,38190.262
192,14:50:30,0.4,1000,400,6,7,53,18,20,5,5,48,13,5,3092.491857551897,9809.738,0.010117053985595703,0.005552053451538086,0.0,38190.262
192,14:50:30,0.4,1000,500,6,7,53,18,20,5,5,48,13,5,3092.491857551897,9809.738,0.009490013122558594,0.005162954330444336,0.0,38190.262
192,14:50:30,0.4,1000,600,6,7,53,18,20,5,5,48,13,5,3092.491857551897,9809.738,0.009699106216430664,0.005079984664916992,0.0,38190.262
192,14:50:30,0.4,1000,700,6,7,53,18,20,5,5,48,13,5,3092.491857551897,9809.738,0.009835958480834961,0.005666017532348633,0.0,38190.262
194,15:17:30,1,1000,0,22,23,11,3,26,0,0,11,3,0,3800.0,9770.212,0.001714944839477539,0.0009970664978027344,0.0,1229.7880000000005
194,15:17:30,1,1000,100,22,23,23,6,28,1,1,22,5,1,3800.0,10688.098000000002,0.0027167797088623047,0.0009188652038574219,0.0,11311.901999999998
194,15:17:30,1,1000,200,22,23,44,10,29,4,7,37,6,4,3800.0,10641.988999999998,0.005023956298828125,0.0011789798736572266,0.0,26358.011000000002
194,15:17:30,1,1000,300,22,23,47,11,30,4,7,40,7,4,3800.0,11169.848999999998,0.005552053451538086,0.0012810230255126953,0.0,28830.151
194,15:17:30,1,1000,400,22,23,47,11,30,4,7,40,7,4,3800.0,11169.848999999998,0.06954813003540039,0.002019166946411133,0.0,28830.151
194,15:17:30,1,1000,500,22,23,47,11,30,4,7,40,7,4,3800.0,11169.848999999998,0.005484104156494141,0.0012650489807128906,0.0,28830.151
194,15:17:30,1,1000,600,22,23,47,11,30,4,7,40,7,4,3800.0,11169.848999999998,0.005427122116088867,0.001199960708618164,0.0,28830.151
194,15:17:30,1,1000,700,22,23,47,11,30,4,7,40,7,4,3800.0,11169.848999999998,0.0062868595123291016,0.0015189647674560547,0.0,28830.151
185,15:27:00,1,1000,0,17,18,16,3,19,2,1,15,1,2,3416.0,8265.086,0.0013670921325683594,0.0008709430694580078,0.0,6734.914000000001
185,15:27:00,1,1000,100,17,18,19,5,21,2,1,18,3,2,3416.0,9163.797999999999,0.0025551319122314453,0.0006041526794433594,0.0,8836.202000000001
185,15:27:00,1,1000,200,17,18,25,7,22,3,3,22,4,3,3484.5553939990423,9602.303999999998,0.002496004104614258,0.0008420944213867188,0.0,12397.696000000002
185,15:27:00,1,1000,300,17,18,26,8,23,3,3,23,5,3,3484.5553939990423,10057.104999999998,0.002750873565673828,0.0009691715240478516,0.0,12942.895000000002
185,15:27:00,1,1000,400,17,18,26,8,23,3,3,23,5,3,3484.5553939990423,10057.104999999998,0.0028579235076904297,0.0009980201721191406,0.0,12942.895000000002
185,15:27:00,1,1000,500,17,18,26,8,23,3,3,23,5,3,3484.5553939990423,10057.104999999998,0.0028579235076904297,0.0010569095611572266,0.0,12942.895000000002
185,15:27:00,1,1000,600,17,18,26,8,23,3,3,23,5,3,3484.5553939990423,10057.104999999998,0.002849102020263672,0.0009801387786865234,0.0,12942.895000000002
185,15:27:00,1,1000,700,17,18,26,8,23,3,3,23,5,3,3484.5553939990423,10057.104999999998,0.00269317626953125,0.0010581016540527344,0.0,12942.895000000002
198,10:24:30,0,1000,0,1,2,1,2,4,0,0,1,2,0,853.5423004652839,3270.5789999999997,0.00017786026000976562,0.00040411949157714844,0.0,-2270.5789999999997
198,10:24:30,0,1000,100,1,2,7,5,7,0,0,7,5,0,869.6575623359458,3332.3289999999997,0.0007102489471435547,0.0005729198455810547,0.0,3667.6710000000003
198,10:24:30,0,1000,200,1,2,10,7,9,0,0,10,7,0,869.6575623359531,3332.3289999999997,0.0014529228210449219,0.0006949901580810547,0.0,6667.671
198,10:24:30,0,1000,300,1,2,17,10,12,0,0,17,10,0,1161.2313215819595,4449.573,0.0036690235137939453,0.0011019706726074219,0.0,12550.427
198,10:24:30,0,1000,400,1,2,17,10,12,0,0,17,10,0,1161.2313215819595,4449.573,0.0037059783935546875,0.0012831687927246094,0.0,12550.427
198,10:24:30,0,1000,500,1,2,17,10,12,0,0,17,10,0,1161.2313215819595,4449.573,0.0038988590240478516,0.0015239715576171875,0.0,12550.427
198,10:24:30,0,1000,600,1,2,17,10,12,0,0,17,10,0,1161.2313215819595,4449.573,0.0038001537322998047,0.0012369155883789062,0.0,12550.427
198,10:24:30,0,1000,700,1,2,17,10,12,0,0,17,10,0,1161.2313215819595,4449.573,0.0037119388580322266,0.0012259483337402344,0.0,12550.427
191,07:22:00,0,1000,0,1,2,3,4,6,0,0,3,4,0,1241.7960788099772,4758.278734896091,0.00039196014404296875,0.0005769729614257812,0.0,-1758.278734896091
191,07:22:00,0,1000,100,1,2,12,8,10,0,0,12,8,0,1310.8095899051768,5022.722734896091,0.0024139881134033203,0.0010120868682861328,0.0,6977.277265103909
191,07:22:00,0,1000,200,1,2,29,15,16,1,1,28,14,1,1944.7991284997843,7452.025734896091,0.011592864990234375,0.002089977264404297,0.0,20547.97426510391
191,07:22:00,0,1000,300,1,2,31,16,17,1,1,30,15,1,2175.85101050885,8337.363734896091,0.014194011688232422,0.0025091171264648438,0.0,21662.63626510391
191,07:22:00,0,1000,400,1,2,31,16,17,1,1,30,15,1,2175.85101050885,8337.363734896091,0.014142990112304688,0.002917051315307617,0.0,21662.63626510391
191,07:22:00,0,1000,500,1,2,31,16,17,1,1,30,15,1,2175.85101050885,8337.363734896091,0.03194904327392578,0.0028009414672851562,0.0,21662.63626510391
191,07:22:00,0,1000,600,1,2,31,16,17,1,1,30,15,1,2175.85101050885,8337.363734896091,0.013639211654663086,0.0027289390563964844,0.0,21662.63626510391
191,07:22:00,0,1000,700,1,2,31,16,17,1,1,30,15,1,2175.85101050885,8337.363734896091,0.013735771179199219,0.0024619102478027344,0.0,21662.63626510391
195,13:21:00,0,1000,0,1,2,5,6,7,1,1,4,5,1,1661.1747643760464,6365.242,0.0008089542388916016,0.0006749629974365234,0.0,-2365.242
195,13:21:00,0,1000,100,1,2,11,12,13,1,1,10,11,1,2405.0153230136057,9215.469000000001,0.003820180892944336,0.00244903564453125,0.0,784.530999999999
195,13:21:00,0,1000,200,1,2,36,26,19,9,8,28,17,9,2585.0,9856.329,0.03976798057556152,0.03298306465148926,0.0,18143.671000000002
195,13:21:00,0,1000,300,1,2,39,29,19,12,11,28,17,12,2572.2643387616336,9856.329,0.05095505714416504,0.1167001724243164,0.0,18143.671000000002
195,13:21:00,0,1000,400,1,2,39,29,19,12,11,28,17,12,2572.2643387616336,9856.329,0.07072114944458008,0.11943697929382324,0.0,18143.671000000002
195,13:21:00,0,1000,500,1,2,40,31,19,14,12,28,17,14,2585.0,9856.329,0.06023120880126953,0.10560917854309082,0.0,18143.671000000002
195,13:21:00,0,1000,600,1,2,40,31,19,14,12,28,17,14,2585.0,9856.329,0.0601048469543457,0.10727810859680176,0.0,18143.671000000002
195,13:21:00,0,1000,700,1,2,40,31,19,14,12,28,17,14,2585.0,9856.329,0.06069207191467285,0.10645103454589844,0.0,18143.671000000002
194,15:17:30,0.2,1000,0,4,5,9,7,7,5,8,1,2,5,2535.0,8182.268,0.0009248256683349609,0.0006170272827148438,0.0,-7182.268
194,15:17:30,0.2,1000,100,4,5,23,16,11,10,19,4,6,10,2869.4083079813863,9268.002,0.0050318241119384766,0.0076580047607421875,0.0,-5268.002
194,15:17:30,0.2,1000,200,4,5,45,26,18,13,36,9,13,13,4371.0,10851.502,0.0186460018157959,0.02609992027282715,0.0,-1851.5020000000004
194,15:17:30,0.2,1000,300,4,5,47,26,17,14,38,9,12,14,2919.4227735027453,10851.502,0.019088268280029297,0.02626800537109375,0.0,-1851.5020000000004
194,15:17:30,0.2,1000,400,4,5,47,26,17,14,38,9,12,14,2919.4227735027453,10851.502,0.018645048141479492,0.025790929794311523,0.0,-1851.5020000000004
194,15:17:30,0.2,1000,500,4,5,47,26,17,14,38,9,12,14,2919.4227735027453,10851.502,0.019355058670043945,0.02678704261779785,0.0,-1851.5020000000004
194,15:17:30,0.2,1000,600,4,5,48,26,19,12,38,10,14,12,4371.0,10851.501999999999,0.01950216293334961,0.024286985397338867,0.0,-851.5019999999986
194,15:17:30,0.2,1000,700,4,5,48,26,19,12,38,10,14,12,4371.0,10851.501999999999,0.01922607421875,0.02590799331665039,0.0,-851.5019999999986
198,19:44:00,0.4,1000,0,3,4,1,2,4,2,1,0,0,2,1368.0,3398.6359999999995,0.0002701282501220703,0.0006060600280761719,0.0,-3398.6359999999995
198,19:44:00,0.4,1000,100,3,4,13,8,11,1,1,12,7,1,1368.0,5064.277999999999,0.0011699199676513672,0.0012350082397460938,0.0,6935.722000000001
198,19:44:00,0.4,1000,200,3,4,22,12,15,1,1,21,11,1,1601.3410805893363,6135.973,0.0029120445251464844,0.001605987548828125,0.0,14864.027
198,19:44:00,0.4,1000,300,3,4,23,12,15,1,1,22,11,1,1601.3410805893363,6135.973,0.003036022186279297,0.0013148784637451172,0.0,15864.027
198,19:44:00,0.4,1000,400,3,4,23,12,15,1,1,22,11,1,1601.3410805893363,6135.973,0.0029599666595458984,0.0012879371643066406,0.0,15864.027
198,19:44:00,0.4,1000,500,3,4,23,12,15,1,1,22,11,1,1601.3410805893363,6135.973,0.003045797348022461,0.002017974853515625,0.0,15864.027
198,19:44:00,0.4,1000,600,3,4,23,12,15,1,1,22,11,1,1601.3410805893363,6135.973,0.003061056137084961,0.0012030601501464844,0.0,15864.027
198,19:44:00,0.4,1000,700,3,4,23,12,15,1,1,22,11,1,1601.3410805893363,6135.973,0.003113985061645508,0.0012180805206298828,0.0,15864.027
191,13:41:30,0,1000,0,1,2,4,4,6,0,0,4,4,0,1392.5075604308586,5335.7706841287045,0.0004591941833496094,0.0005540847778320312,0.0,-1335.7706841287045
191,13:41:30,0,1000,100,1,2,8,6,8,0,0,8,6,0,1591.106045279339,6096.754684128705,0.001157999038696289,0.0007150173187255859,0.0,1903.2453158712951
191,13:41:30,0,1000,200,1,2,21,12,13,1,1,20,11,1,1714.017082323022,6567.721684128705,0.00654911994934082,0.0017271041870117188,0.0,13432.278315871295
191,13:41:30,0,1000,300,1,2,23,13,14,1,1,22,12,1,1714.017082323022,6567.721684128705,0.007698774337768555,0.002071857452392578,0.0,15432.278315871295
191,13:41:30,0,1000,400,1,2,23,13,14,1,1,22,12,1,1714.017082323022,6567.721684128705,0.0074160099029541016,0.0017480850219726562,0.0,15432.278315871295
191,13:41:30,0,1000,500,1,2,23,13,14,1,1,22,12,1,1714.017082323022,6567.721684128705,0.007456064224243164,0.0017781257629394531,0.0,15432.278315871295
191,13:41:30,0,1000,600,1,2,23,13,14,1,1,22,12,1,1714.017082323022,6567.721684128705,0.007534027099609375,0.0016429424285888672,0.0,15432.278315871295
191,13:41:30,0,1000,700,1,2,23,13,14,1,1,22,12,1,1714.017082323022,6567.721684128705,0.0075800418853759766,0.002254962921142578,0.0,15432.278315871295
198,10:24:30,0.4,1000,0,3,4,1,1,5,0,0,1,1,0,1171.278655153903,3270.5789999999997,0.00021505355834960938,0.0005230903625488281,0.0,-2270.5789999999997
198,10:24:30,0.4,1000,100,3,4,7,3,7,0,0,7,3,0,1419.0,4257.166,0.0004911422729492188,0.0007748603820800781,0.0,2742.834
198,10:24:30,0.4,1000,200,3,4,10,5,9,0,0,10,5,0,1187.3939170245794,4257.166,0.0007150173187255859,0.0008599758148193359,0.0,5742.834
198,10:24:30,0.4,1000,300,3,4,17,8,11,1,1,16,7,1,1355.9001506203786,4449.573,0.001683950424194336,0.0015001296997070312,0.0,11550.427
198,10:24:30,0.4,1000,400,3,4,17,8,11,1,1,16,7,1,1355.9001506203786,4449.573,0.001500844955444336,0.0015799999237060547,0.0,11550.427
198,10:24:30,0.4,1000,500,3,4,17,8,11,1,1,16,7,1,1355.9001506203786,4449.573,0.0015077590942382812,0.0013680458068847656,0.0,11550.427
198,10:24:30,0.4,1000,600,3,4,17,8,11,1,1,16,7,1,1355.9001506203786,4449.573,0.0014660358428955078,0.0014710426330566406,0.0,11550.427
198,10:24:30,0.4,1000,700,3,4,17,8,11,1,1,16,7,1,1355.9001506203786,4449.573,0.0015649795532226562,0.0014300346374511719,0.0,11550.427
155,07:44:30,1,1000,0,12,13,4,1,14,0,0,4,1,0,3007.0,8157.828,0.0006551742553710938,0.0003879070281982422,0.0,-4157.828
155,07:44:30,1,1000,100,12,13,5,2,15,0,0,5,2,0,3007.0,8185.946000000001,0.0008070468902587891,0.0005578994750976562,0.0,-3185.946000000001
155,07:44:30,1,1000,200,12,13,24,8,18,3,3,21,5,3,3007.0,9100.257,0.0020999908447265625,0.0009670257568359375,0.0,11899.743
155,07:44:30,1,1000,300,12,13,40,13,20,6,6,34,7,6,3007.0,10015.639999999998,0.004297971725463867,0.0024688243865966797,0.0,23984.36
155,07:44:30,1,1000,400,12,13,45,13,21,5,7,38,8,5,3007.0,10756.883,0.005473136901855469,0.0030460357666015625,0.0,27243.117
155,07:44:30,1,1000,500,12,13,45,13,21,5,7,38,8,5,3007.0,10756.883,0.004559993743896484,0.002952098846435547,0.0,27243.117
155,07:44:30,1,1000,600,12,13,45,13,21,5,7,38,8,5,3007.0,10756.883,0.0046939849853515625,0.0028998851776123047,0.0,27243.117
155,07:44:30,1,1000,700,12,13,45,13,21,5,7,38,8,5,3007.0,10756.883,0.004836082458496094,0.00333404541015625,0.0,27243.117
155,07:44:30,0,1000,0,1,2,4,5,7,0,0,4,5,0,1368.0487204724413,5242.050000000001,0.0005488395690917969,0.0006380081176757812,0.0,-1242.050000000001
155,07:44:30,0,1000,100,1,2,13,14,14,2,2,11,12,2,1663.6339402887133,6374.665000000001,0.005707979202270508,0.0017549991607666016,0.0,4625.334999999999
155,07:44:30,0,1000,200,1,2,42,22,23,1,1,41,21,1,2578.993080410404,9882.112000000001,0.03241324424743652,0.008094072341918945,0.0,31117.888
155,07:44:30,0,1000,300,1,2,45,25,26,1,1,44,24,1,2673.264622106897,10243.339,0.043854713439941406,0.0061948299407958984,0.0,33756.661
155,07:44:30,0,1000,400,1,2,45,25,26,1,1,44,24,1,2673.264622106897,10243.339,0.04545474052429199,0.005918025970458984,0.0,33756.661
155,07:44:30,0,1000,500,1,2,45,25,26,1,1,44,24,1,2673.264622106897,10243.339,0.044080257415771484,0.005661964416503906,0.0,33756.661
155,07:44:30,0,1000,600,1,2,45,25,26,1,1,44,24,1,2673.264622106897,10243.339,0.0457761287689209,0.00577998161315918,0.0,33756.661
155,07:44:30,0,1000,700,1,2,45,25,26,1,1,44,24,1,2673.264622106897,10243.339,0.04387497901916504,0.005792856216430664,0.0,33756.661
191,13:41:30,1,1000,0,14,15,4,1,16,0,0,4,1,0,2219.0,5535.810684128705,0.0006079673767089844,0.0005078315734863281,0.0,-1535.8106841287054
191,13:41:30,1,1000,100,14,15,10,1,16,0,0,10,1,0,2219.0,5535.810684128705,0.0008349418640136719,0.0004918575286865234,0.0,4464.189315871295
191,13:41:30,1,1000,200,14,15,22,4,17,2,3,19,2,2,2219.0,5535.810684128705,0.0018863677978515625,0.0006239414215087891,0.0,13464.189315871296
191,13:41:30,1,1000,300,14,15,22,4,17,2,3,19,2,2,2219.0,5535.810684128705,0.0016579627990722656,0.0007429122924804688,0.0,13464.189315871296
191,13:41:30,1,1000,400,14,15,23,5,17,3,4,19,2,3,2219.0,5535.810684128705,0.0021843910217285156,0.0008139610290527344,0.0,13464.189315871296
191,13:41:30,1,1000,500,14,15,23,5,17,3,4,19,2,3,2219.0,5535.810684128705,0.0019850730895996094,0.0006659030914306641,0.0,13464.189315871296
191,13:41:30,1,1000,600,14,15,23,5,17,3,4,19,2,3,2219.0,5535.810684128705,0.001943826675415039,0.0006940364837646484,0.0,13464.189315871296
191,13:41:30,1,1000,700,14,15,23,5,17,3,4,19,2,3,2219.0,5535.810684128705,0.0020210742950439453,0.0007319450378417969,0.0,13464.189315871296
198,10:24:30,0.2,1000,0,2,3,1,2,5,0,0,1,2,0,1063.0,3270.5789999999997,0.00021600723266601562,0.00045299530029296875,0.0,-2270.5789999999997
198,10:24:30,0.2,1000,100,2,3,7,4,7,0,0,7,4,0,1063.0,3332.329,0.0004849433898925781,0.0005269050598144531,0.0,3667.671
198,10:24:30,0.2,1000,200,2,3,10,6,9,0,0,10,6,0,1063.0,3332.3289999999997,0.0007910728454589844,0.0006871223449707031,0.0,6667.671
198,10:24:30,0.2,1000,300,2,3,17,9,12,0,0,17,9,0,1161.2313215819595,4449.573,0.0019259452819824219,0.0018811225891113281,0.0,12550.427
198,10:24:30,0.2,1000,400,2,3,17,9,12,0,0,17,9,0,1161.2313215819595,4449.573,0.0019702911376953125,0.000762939453125,0.0,12550.427
198,10:24:30,0.2,1000,500,2,3,17,9,12,0,0,17,9,0,1161.2313215819595,4449.573,0.002050161361694336,0.0007841587066650391,0.0,12550.427
198,10:24:30,0.2,1000,600,2,3,17,9,12,0,0,17,9,0,1161.2313215819595,4449.573,0.0019729137420654297,0.0009500980377197266,0.0,12550.427
198,10:24:30,0.2,1000,700,2,3,17,9,12,0,0,17,9,0,1161.2313215819595,4449.573,0.0019290447235107422,0.0007150173187255859,0.0,12550.427
198,10:24:30,1,1000,0,7,8,1,1,9,0,0,1,1,0,1185.3939170245794,3332.3289999999997,0.00027632713317871094,0.0003809928894042969,0.0,-2332.3289999999997
198,10:24:30,1,1000,100,7,8,12,1,9,0,0,12,1,0,1185.3939170245794,3332.3289999999997,0.0005741119384765625,0.00035691261291503906,0.0,8667.671
198,10:24:30,1,1000,200,7,8,15,2,10,0,0,15,2,0,1225.8038430565575,4171.6359999999995,0.0007061958312988281,0.00040793418884277344,0.0,10828.364000000001
198,10:24:30,1,1000,300,7,8,17,4,10,2,2,15,2,2,1350.9999999999927,3865.7749999999996,0.0009012222290039062,0.0006589889526367188,0.0,11134.225
198,10:24:30,1,1000,400,7,8,17,4,10,2,2,15,2,2,1350.9999999999927,3865.7749999999996,0.0010228157043457031,0.00078582763671875,0.0,11134.225
198,10:24:30,1,1000,500,7,8,17,4,10,2,2,15,2,2,1350.9999999999927,3865.7749999999996,0.0009317398071289062,0.0007600784301757812,0.0,11134.225
198,10:24:30,1,1000,600,7,8,17,4,10,2,2,15,2,2,1350.9999999999927,3865.7749999999996,0.0008881092071533203,0.0009131431579589844,0.0,11134.225
198,10:24:30,1,1000,700,7,8,17,4,10,2,2,15,2,2,1350.9999999999927,3865.7749999999996,0.0009930133819580078,0.0009579658508300781,0.0,11134.225
195,13:21:00,1,1000,0,22,23,8,3,26,0,0,8,3,0,3950.0,10131.736,0.001416921615600586,0.0006701946258544922,0.0,-2131.736000000001
195,13:21:00,1,1000,100,22,23,18,5,28,0,0,18,5,0,4198.532808398952,11627.895999999999,0.0020589828491210938,0.0007529258728027344,0.0,6372.104000000001
195,13:21:00,1,1000,200,22,23,36,8,31,0,0,36,8,0,4198.532808398952,12658.089000000002,0.0034949779510498047,0.0009279251098632812,0.0,23341.911
195,13:21:00,1,1000,300,22,23,39,11,31,3,2,37,8,3,4198.532808398952,12658.089000000002,0.004702091217041016,0.003590106964111328,0.0,24341.911
195,13:21:00,1,1000,400,22,23,39,11,31,3,2,37,8,3,4198.532808398952,12658.089000000002,0.00499415397644043,0.003213167190551758,0.0,24341.911
195,13:21:00,1,1000,500,22,23,40,13,31,5,3,37,8,5,4198.532808398952,12658.089000000002,0.0058460235595703125,0.0033690929412841797,0.0,24341.911
195,13:21:00,1,1000,600,22,23,40,13,31,5,3,37,8,5,4198.532808398952,12658.089000000002,0.0056269168853759766,0.003202199935913086,0.0,24341.911
195,13:21:00,1,1000,700,22,23,40,13,31,5,3,37,8,5,4198.532808398952,12658.089000000002,0.006395816802978516,0.003083944320678711,0.0,24341.911
191,07:22:00,1,1000,0,13,14,10,0,14,0,0,10,0,0,2317.0,5095.854734896091,0.0008330345153808594,0.0004258155822753906,0.0,4904.145265103909
191,07:22:00,1,1000,100,13,14,20,1,14,1,1,19,0,1,2317.0,5095.854734896091,0.0012848377227783203,0.0003871917724609375,0.0,13904.145265103909
191,07:22:00,1,1000,200,13,14,29,4,15,3,4,25,1,3,2197.0,5613.634734896091,0.001889944076538086,0.000537872314453125,0.0,19386.36526510391
191,07:22:00,1,1000,300,13,14,31,5,15,4,6,25,1,4,2197.0,5613.634734896091,0.0020301342010498047,0.0004661083221435547,0.0,19386.36526510391
191,07:22:00,1,1000,400,13,14,31,5,15,4,6,25,1,4,2197.0,5613.634734896091,0.002035856246948242,0.0004718303680419922,0.0,19386.36526510391
191,07:22:00,1,1000,500,13,14,31,5,15,4,6,25,1,4,2197.0,5613.634734896091,0.002161741256713867,0.0006260871887207031,0.0,19386.36526510391
191,07:22:00,1,1000,600,13,14,31,5,15,4,6,25,1,4,2197.0,5613.634734896091,0.0021567344665527344,0.0005700588226318359,0.0,19386.36526510391
191,07:22:00,1,1000,700,13,14,31,5,15,4,6,25,1,4,2197.0,5613.634734896091,0.002309083938598633,0.0005002021789550781,0.0,19386.36526510391
194,15:17:30,0,1000,0,1,2,9,8,10,0,0,9,8,0,2416.9531436411344,9261.212000000001,0.0017359256744384766,0.0009448528289794922,0.0,-261.21200000000135
194,15:17:30,0,1000,100,1,2,23,18,20,0,0,23,18,0,2769.7737711763257,10613.139999999998,0.013147830963134766,0.002736806869506836,0.0,12386.860000000002
194,15:17:30,0,1000,200,1,2,45,29,31,0,0,45,29,0,3909.0,13135.418,0.05862689018249512,0.015866994857788086,0.0,31864.582000000002
194,15:17:30,0,1000,300,1,2,47,29,31,0,0,47,29,0,3909.0,13135.418,0.062256813049316406,0.01584315299987793,0.0,33864.582
194,15:17:30,0,1000,400,1,2,47,29,31,0,0,47,29,0,3909.0,13135.418,0.0630788803100586,0.01651620864868164,0.0,33864.582
194,15:17:30,0,1000,500,1,2,47,29,31,0,0,47,29,0,3909.0,13135.418,0.062213897705078125,0.016367197036743164,0.0,33864.582
194,15:17:30,0,1000,600,1,2,48,29,31,0,0,48,29,0,3909.0,13135.418,0.06416583061218262,0.015898942947387695,0.0,34864.582
194,15:17:30,0,1000,700,1,2,48,29,31,0,0,48,29,0,3909.0,13135.418,0.06343293190002441,0.014520883560180664,0.0,34864.582
198,19:44:00,0.2,1000,0,1,2,1,2,4,0,0,1,2,0,955.4319896802626,3660.9970000000003,0.0001888275146484375,0.0003771781921386719,0.0,-2660.9970000000003
198,19:44:00,0.2,1000,100,1,2,13,10,12,0,0,13,10,0,1363.4111787162983,5224.28,0.0030400753021240234,0.0024330615997314453,0.0,7775.72
198,19:44:00,0.2,1000,200,1,2,22,14,16,0,0,22,14,0,1643.0977466594923,6295.974999999999,0.008346796035766602,0.011031866073608398,0.0,15704.025000000001
198,19:44:00,0.2,1000,300,1,2,23,14,16,0,0,23,14,0,1643.0977466595068,6295.974999999999,0.008674860000610352,0.01465606689453125,0.0,16704.025
198,19:44:00,0.2,1000,400,1,2,23,14,16,0,0,23,14,0,1643.0977466595068,6295.974999999999,0.008687973022460938,0.014634847640991211,0.0,16704.025
198,19:44:00,0.2,1000,500,1,2,23,14,16,0,0,23,14,0,1643.0977466595068,6295.974999999999,0.008525848388671875,0.013991117477416992,0.0,16704.025
198,19:44:00,0.2,1000,600,1,2,23,14,16,0,0,23,14,0,1643.0977466595068,6295.974999999999,0.008459091186523438,0.014595985412597656,0.0,16704.025
198,19:44:00,0.2,1000,700,1,2,23,14,16,0,0,23,14,0,1643.0977466595068,6295.974999999999,0.008862972259521484,0.014683961868286133,0.0,16704.025
194,15:17:30,0.4,1000,0,9,10,9,5,15,0,0,9,5,0,3326.0,9261.212,0.0012519359588623047,0.0005638599395751953,0.0,-261.21199999999953
194,15:17:30,0.4,1000,100,9,10,24,12,21,1,1,23,11,1,3326.0,10289.976,0.0028667449951171875,0.0013821125030517578,0.0,12710.024
194,15:17:30,0.4,1000,200,9,10,45,21,25,6,10,35,15,6,3326.0,10278.422999999997,0.00786590576171875,0.0025920867919921875,0.0,24721.577000000005
194,15:17:30,0.4,1000,300,9,10,47,21,25,6,10,37,15,6,3326.0,10278.422999999997,0.008031129837036133,0.0025589466094970703,0.0,26721.577000000005
194,15:17:30,0.4,1000,400,9,10,47,21,25,6,10,37,15,6,3326.0,10278.422999999997,0.008450984954833984,0.003281116485595703,0.0,26721.577000000005
194,15:17:30,0.4,1000,500,9,10,47,21,25,6,10,37,15,6,3326.0,10278.422999999997,0.00850820541381836,0.0029921531677246094,0.0,26721.577000000005
194,15:17:30,0.4,1000,600,9,10,48,21,25,6,10,38,15,6,3326.0,10278.422999999997,0.008373022079467773,0.0026950836181640625,0.0,27721.577000000005
194,15:17:30,0.4,1000,700,9,10,48,21,25,6,10,38,15,6,3326.0,10278.422999999997,0.00821995735168457,0.0025758743286132812,0.0,27721.577000000005
185,15:27:00,0,1000,0,1,2,4,5,5,2,1,3,3,2,1820.5350005965156,6975.874,0.0005958080291748047,0.0006999969482421875,0.0,-3975.874
185,15:27:00,0,1000,100,1,2,8,7,7,2,1,7,5,2,1902.419321164387,7289.6359999999995,0.00225830078125,0.0010068416595458984,0.0,-289.6359999999995
185,15:27:00,0,1000,200,1,2,22,18,18,2,2,20,16,2,2311.167084228109,8855.864000000001,0.013046026229858398,0.0028760433197021484,0.0,11144.135999999999
185,15:27:00,0,1000,300,1,2,26,22,22,2,2,24,20,2,2778.761781197798,10647.579999999998,0.021178007125854492,0.0037779808044433594,0.0,13352.420000000002
185,15:27:00,0,1000,400,1,2,26,22,22,2,2,24,20,2,2778.761781197798,10647.579999999998,0.021183013916015625,0.0036301612854003906,0.0,13352.420000000002
185,15:27:00,0,1000,500,1,2,26,22,22,2,2,24,20,2,2778.761781197798,10647.579999999998,0.02203679084777832,0.003916025161743164,0.0,13352.420000000002
185,15:27:00,0,1000,600,1,2,26,22,22,2,2,24,20,2,2778.761781197798,10647.579999999998,0.021965980529785156,0.003983020782470703,0.0,13352.420000000002
185,15:27:00,0,1000,700,1,2,26,22,22,2,2,24,20,2,2778.761781197798,10647.579999999998,0.02122020721435547,0.0036699771881103516,0.0,13352.420000000002
195,13:21:00,0.2,1000,0,4,5,8,8,12,1,1,7,7,1,3163.0,10005.380000000001,0.0007927417755126953,0.0016460418701171875,0.0,-3005.380000000001
195,13:21:00,0.2,1000,100,4,5,16,14,15,4,3,13,10,4,3163.0,11427.923,0.0026099681854248047,0.004054069519042969,0.0,1572.0769999999993
195,13:21:00,0.2,1000,200,4,5,34,22,20,7,7,27,15,7,3163.0,11971.831999999999,0.00978708267211914,0.07547187805175781,0.0,15028.168000000001
195,13:21:00,0.2,1000,300,4,5,39,28,23,10,11,28,18,10,3163.0,11908.114,0.016347885131835938,0.14380788803100586,0.0,16091.886
195,13:21:00,0.2,1000,400,4,5,39,28,23,10,11,28,18,10,3163.0,11908.114,0.016247987747192383,0.14381694793701172,0.0,16091.886
195,13:21:00,0.2,1000,500,4,5,40,30,23,12,12,28,18,12,3163.0,11908.114,0.018836021423339844,0.16367506980895996,0.0,16091.886
195,13:21:00,0.2,1000,600,4,5,40,30,23,12,12,28,18,12,3163.0,11908.114,0.018932104110717773,0.16457295417785645,0.0,16091.886
195,13:21:00,0.2,1000,700,4,5,40,30,23,12,12,28,18,12,3163.0,11908.114,0.019298791885375977,0.16998910903930664,0.0,16091.886
194,07:10:00,0.2,1000,0,4,5,8,8,13,0,0,8,8,0,2927.0,10182.422,0.0008656978607177734,0.0009899139404296875,0.0,-2182.4220000000005
194,07:10:00,0.2,1000,100,4,5,33,15,17,3,2,31,12,3,2927.0,10281.585000000001,0.006360054016113281,0.0015130043029785156,0.0,20718.415
194,07:10:00,0.2,1000,200,4,5,48,21,25,1,1,47,20,1,3922.2985787998114,14917.775,0.014590978622436523,0.02919602394104004,0.0,32082.225
194,07:10:00,0.2,1000,300,4,5,51,23,27,1,1,50,22,1,3922.2985787998114,14917.774999999996,0.017631053924560547,0.03653907775878906,0.0,35082.225000000006
194,07:10:00,0.2,1000,400,4,5,51,23,27,1,1,50,22,1,3922.2985787998114,14917.774999999996,0.01822519302368164,0.03815412521362305,0.0,35082.225000000006
194,07:10:00,0.2,1000,500,4,5,51,23,27,1,1,50,22,1,3922.2985787998114,14917.774999999996,0.018358945846557617,0.03644514083862305,0.0,35082.225000000006
194,07:10:00,0.2,1000,600,4,5,51,23,27,1,1,50,22,1,3922.2985787998114,14917.774999999996,0.018115758895874023,0.03923606872558594,0.0,35082.225000000006
194,07:10:00,0.2,1000,700,4,5,51,23,27,1,1,50,22,1,3922.2985787998114,14917.774999999996,0.018143892288208008,0.0361180305480957,0.0,35082.225000000006
55,15:58:00,0,1000,0,1,2,3,5,5,2,1,2,3,2,2469.1013481269474,9461.032000000001,0.0004961490631103516,0.0007410049438476562,0.0,-7461.032000000001
55,15:58:00,0,1000,100,1,2,15,13,13,2,1,14,11,2,3055.7806534836564,11709.053000000002,0.005491018295288086,0.001638174057006836,0.0,2290.9469999999983
55,15:58:00,0,1000,200,1,2,36,24,24,2,1,35,22,2,3995.8432504175507,15311.158000000005,0.03474092483520508,0.04511213302612305,0.0,19688.841999999997
55,15:58:00,0,1000,300,1,2,65,34,34,2,1,64,32,2,4692.528334526367,17980.696000000004,0.11363410949707031,0.0855410099029541,0.0,46019.304
55,15:58:00,0,1000,400,1,2,71,34,34,2,1,70,32,2,5470.0,17980.696000000007,0.1233358383178711,0.07530903816223145,3.881892255520805e-05,52019.30399999999
55,15:58:00,0,1000,500,1,2,71,34,34,2,1,70,32,2,5470.0,17980.696000000007,0.1235499382019043,0.07694101333618164,3.881892255520805e-05,52019.30399999999
55,15:58:00,0,1000,600,1,2,71,34,34,2,1,70,32,2,5470.0,17980.696000000007,0.12240195274353027,0.07597494125366211,3.881892255520805e-05,52019.30399999999
55,15:58:00,0,1000,700,1,2,71,34,34,2,1,70,32,2,5470.0,17980.696000000007,0.12228107452392578,0.07631897926330566,3.881892255520805e-05,52019.30399999999
199,13:24:30,0,1000,0,1,2,3,3,2,3,3,0,0,3,3444.0,5500.129000000001,0.00034499168395996094,0.0007200241088867188,0.0,-5500.129000000001
199,13:24:30,0,1000,100,1,2,17,15,15,2,3,14,13,2,2717.7701473395355,10413.874000000002,0.007525920867919922,0.0025119781494140625,0.0,3586.1259999999984
199,13:24:30,0,1000,200,1,2,26,21,21,2,3,23,19,2,3365.5885379384417,12896.166,0.019178152084350586,0.007980108261108398,0.0,10103.834
199,13:24:30,0,1000,300,1,2,28,22,22,2,3,25,20,2,3379.2010409210197,12948.326,0.023339033126831055,0.009489059448242188,0.0,12051.674
199,13:24:30,0,1000,400,1,2,29,23,23,2,3,26,21,2,3420.3684234073007,13106.069999999998,0.025851964950561523,0.005187034606933594,0.0,12893.930000000002
199,13:24:30,0,1000,500,1,2,30,23,23,2,4,26,21,2,3420.3684234073007,13106.069999999998,0.025828123092651367,0.005074977874755859,0.0,12893.930000000002
199,13:24:30,0,1000,600,1,2,30,23,23,2,4,26,21,2,3420.3684234073007,13106.069999999998,0.026757001876831055,0.005423069000244141,0.0,12893.930000000002
199,13:24:30,0,1000,700,1,2,30,23,23,2,4,26,21,2,3420.3684234073007,13106.069999999998,0.027821063995361328,0.00554203987121582,0.0,12893.930000000002
196,09:57:30,1,1000,0,14,15,4,2,17,0,0,4,2,0,3405.0,8516.827000000001,0.0006442070007324219,0.0006577968597412109,0.0,-4516.827000000001
196,09:57:30,1,1000,100,14,15,12,3,18,0,0,12,3,0,3353.8571492483898,9521.330000000002,0.0010619163513183594,0.0006477832794189453,0.0,2478.6699999999983
196,09:57:30,1,1000,200,14,15,14,4,19,0,0,14,4,0,3353.8571492483898,9544.195000000002,0.0012586116790771484,0.0006630420684814453,0.0,4455.8049999999985
196,09:57:30,1,1000,300,14,15,15,4,19,0,0,15,4,0,3353.8571492483898,9544.195000000002,0.0012509822845458984,0.0006399154663085938,0.0,5455.8049999999985
196,09:57:30,1,1000,400,14,15,15,4,19,0,0,15,4,0,3353.8571492483898,9544.195000000002,0.0012791156768798828,0.0007410049438476562,0.0,5455.8049999999985
196,09:57:30,1,1000,500,14,15,15,4,19,0,0,15,4,0,3353.8571492483898,9544.195000000002,0.001489877700805664,0.0007550716400146484,0.0,5455.8049999999985
196,09:57:30,1,1000,600,14,15,15,4,19,0,0,15,4,0,3353.8571492483898,9544.195000000002,0.0013718605041503906,0.0008769035339355469,0.0,5455.8049999999985
196,09:57:30,1,1000,700,14,15,15,4,19,0,0,15,4,0,3353.8571492483898,9544.195000000002,0.001397848129272461,0.0007741451263427734,0.0,5455.8049999999985
185,07:21:00,1,1000,0,28,29,27,5,34,0,0,27,5,0,5533.0,15392.803000000004,0.003008127212524414,0.0008389949798583984,0.0,11607.196999999996
185,07:21:00,1,1000,100,28,29,43,7,35,1,1,42,6,1,5533.0,15797.969000000005,0.004363059997558594,0.0009729862213134766,0.0,26202.030999999995
185,07:21:00,1,1000,200,28,29,76,16,41,4,5,71,12,4,5660.84032003102,19096.40100000002,0.010190725326538086,0.0035190582275390625,0.0,51903.59900000002
185,07:21:00,1,1000,300,28,29,88,19,43,5,6,82,14,5,5812.809979718444,19837.02,0.012429952621459961,0.005188941955566406,0.0,62162.979999999996
185,07:21:00,1,1000,400,28,29,89,19,43,5,6,83,14,5,5812.809979718444,19837.02,0.012449026107788086,0.005373954772949219,0.0,63162.979999999996
185,07:21:00,1,1000,500,28,29,89,19,43,5,6,83,14,5,5812.809979718444,19837.02,0.014145851135253906,0.005759000778198242,0.0,63162.979999999996
185,07:21:00,1,1000,600,28,29,89,19,43,5,6,83,14,5,5812.809979718444,19837.02,0.013437986373901367,0.005539894104003906,0.0,63162.979999999996
185,07:21:00,1,1000,700,28,29,89,19,43,5,6,83,14,5,5812.809979718444,19837.02,0.014088869094848633,0.00589299201965332,0.0,63162.979999999996
191,07:22:00,0.2,1000,0,2,3,3,3,4,2,1,2,1,2,1768.0,4674.585734896091,0.0003619194030761719,0.0006351470947265625,0.0,-2674.585734896091
191,07:22:00,0.2,1000,100,2,3,12,7,10,0,0,12,7,0,1768.0,6399.636734896091,0.0011987686157226562,0.0019931793212890625,0.0,5600.363265103909
191,07:22:00,0.2,1000,200,2,3,29,14,16,1,1,28,13,1,2378.0,8828.939734896092,0.005805015563964844,0.007689952850341797,0.0,19171.060265103908
191,07:22:00,0.2,1000,300,2,3,31,15,16,2,2,29,13,2,2350.0320681323356,9004.785734896092,0.0070269107818603516,0.01860213279724121,0.0,19995.21426510391
191,07:22:00,0.2,1000,400,2,3,31,15,16,2,2,29,13,2,2350.0320681323356,9004.785734896092,0.006952047348022461,0.019058942794799805,0.0,19995.21426510391
191,07:22:00,0.2,1000,500,2,3,31,15,16,2,2,29,13,2,2350.0320681323356,9004.785734896092,0.007339000701904297,0.020138025283813477,0.0,19995.21426510391
191,07:22:00,0.2,1000,600,2,3,31,15,16,2,2,29,13,2,2350.0320681323356,9004.785734896092,0.007107973098754883,0.01977396011352539,0.0,19995.21426510391
191,07:22:00,0.2,1000,700,2,3,31,15,16,2,2,29,13,2,2350.0320681323356,9004.785734896092,0.007113218307495117,0.019190073013305664,0.0,19995.21426510391
199,16:04:00,0.4,1000,0,8,9,1,1,10,0,0,1,1,0,4495.0,9545.681999999999,0.00034499168395996094,0.0004260540008544922,0.0,-8545.681999999999
199,16:04:00,0.4,1000,100,8,9,10,3,12,0,0,10,3,0,3757.0,10568.310000000001,0.0006887912750244141,0.0005900859832763672,0.0,-568.3100000000013
199,16:04:00,0.4,1000,200,8,9,16,11,20,0,0,16,11,0,3878.371286685753,13108.408,0.0031380653381347656,0.0013399124145507812,0.0,2891.5920000000006
199,16:04:00,0.4,1000,300,8,9,25,15,22,2,6,19,13,2,3885.21303089954,13134.624,0.006659030914306641,0.0015621185302734375,0.0,5865.376
199,16:04:00,0.4,1000,400,8,9,27,15,22,2,6,21,13,2,3885.21303089954,13134.624,0.006479740142822266,0.0016629695892333984,0.0,7865.376
199,16:04:00,0.4,1000,500,8,9,27,15,22,2,6,21,13,2,3885.21303089954,13134.624,0.00598597526550293,0.001667022705078125,0.0,7865.376
199,16:04:00,0.4,1000,600,8,9,43,16,23,2,6,37,14,2,4216.031302195181,14402.244,0.009016990661621094,0.0016701221466064453,0.0,22597.756
199,16:04:00,0.4,1000,700,8,9,43,16,23,2,6,37,14,2,4216.031302195181,14402.244,0.009391069412231445,0.0018999576568603516,0.0,22597.756
193,13:30:30,1,1000,0,14,15,9,2,17,0,0,9,2,0,2548.0,6622.573000000001,0.0009100437164306641,0.0007500648498535156,0.0,2377.4269999999988
193,13:30:30,1,1000,100,14,15,28,6,18,3,6,22,3,3,2548.0,6905.104000000001,0.002618074417114258,0.0008869171142578125,0.0,15094.895999999999
193,13:30:30,1,1000,200,14,15,42,9,19,5,11,31,4,5,2548.0,7692.413000000001,0.004370927810668945,0.0008039474487304688,0.0,23307.587
193,13:30:30,1,1000,300,14,15,47,9,19,5,11,36,4,5,2548.0,7692.413000000001,0.003964900970458984,0.0007989406585693359,0.0,28307.587
193,13:30:30,1,1000,400,14,15,48,9,19,5,11,37,4,5,2548.0,7692.413000000001,0.004110097885131836,0.0009129047393798828,0.0,29307.587
193,13:30:30,1,1000,500,14,15,48,9,19,5,11,37,4,5,2548.0,7692.413000000001,0.0045261383056640625,0.0010280609130859375,0.0,29307.587
193,13:30:30,1,1000,600,14,15,48,9,19,5,11,37,4,5,2548.0,7692.413000000001,0.004257917404174805,0.000946044921875,0.0,29307.587
193,13:30:30,1,1000,700,14,15,48,9,19,5,11,37,4,5,2548.0,7692.413000000001,0.024113178253173828,0.0008528232574462891,0.0,29307.587
193,13:30:30,0.2,1000,0,3,4,5,6,5,5,4,1,1,5,3215.0,5513.550000000001,0.0005886554718017578,0.0005199909210205078,0.0,-4513.550000000001
193,13:30:30,0.2,1000,100,3,4,23,13,9,8,16,7,5,8,3215.0,6138.485000000001,0.004033088684082031,0.0029098987579345703,0.0,861.5149999999994
193,13:30:30,0.2,1000,200,3,4,41,19,12,11,25,16,8,11,3215.0,6822.531,0.013007164001464844,0.0032041072845458984,0.0,9177.469000000001
193,13:30:30,0.2,1000,300,3,4,47,20,12,12,29,18,8,12,1780.5161730493855,6822.531,0.016386985778808594,0.002335071563720703,0.0,11177.469000000001
193,13:30:30,0.2,1000,400,3,4,48,20,12,12,29,19,8,12,1780.516173049371,6822.531,0.017030954360961914,0.003061056137084961,0.0,12177.469000000001
193,13:30:30,0.2,1000,500,3,4,48,20,12,12,29,19,8,12,1780.516173049371,6822.531,0.016340017318725586,0.002832174301147461,0.0,12177.469000000001
193,13:30:30,0.2,1000,600,3,4,48,20,12,12,29,19,8,12,1780.516173049371,6822.531,0.016076087951660156,0.0028460025787353516,0.0,12177.469000000001
193,13:30:30,0.2,1000,700,3,4,48,20,12,12,29,19,8,12,1780.516173049371,6822.531,0.016505002975463867,0.0028629302978515625,0.0,12177.469000000001
199,13:24:30,0.2,1000,0,4,5,4,4,7,2,2,2,2,2,3690.0,11631.552,0.0004353523254394531,0.0005559921264648438,0.0,-9631.552
199,13:24:30,0.2,1000,100,4,5,17,13,17,1,2,15,12,1,5628.0,14649.781000000003,0.003290891647338867,0.002686023712158203,0.0,350.2189999999973
199,13:24:30,0.2,1000,200,4,5,26,19,18,6,9,17,13,6,4012.7186605225506,14968.298000000003,0.006559848785400391,0.004731893539428711,0.0,2031.7019999999975
199,13:24:30,0.2,1000,300,4,5,29,21,20,6,9,20,15,6,4280.946708721065,15182.430000000002,0.0077610015869140625,0.004518985748291016,0.0,4817.569999999998
199,13:24:30,0.2,1000,400,4,5,29,21,20,6,9,20,15,6,4280.946708721065,15182.430000000002,0.007798910140991211,0.004472017288208008,0.0,4817.569999999998
199,13:24:30,0.2,1000,500,4,5,30,21,20,6,10,20,15,6,4280.946708721065,15182.430000000002,0.008281230926513672,0.0048542022705078125,0.0,4817.569999999998
199,13:24:30,0.2,1000,600,4,5,30,21,20,6,10,20,15,6,4280.946708721065,15182.430000000002,0.008233070373535156,0.004825115203857422,0.0,4817.569999999998
199,13:24:30,0.2,1000,700,4,5,30,21,20,6,10,20,15,6,4280.946708721065,15182.430000000002,0.008483171463012695,0.004931926727294922,0.0,4817.569999999998
192,14:50:30,1,1000,0,14,15,11,0,15,0,0,11,0,0,3521.0,7828.003,0.0008280277252197266,0.0004811286926269531,0.0,3171.9970000000003
192,14:50:30,1,1000,100,14,15,31,3,18,0,0,31,3,0,3406.0,8332.754,0.0020799636840820312,0.0007128715515136719,0.0,22667.246
192,14:50:30,1,1000,200,14,15,48,7,21,1,1,47,6,1,3406.0,9149.129999999997,0.0036809444427490234,0.0014660358428955078,0.0,37850.87
192,14:50:30,1,1000,300,14,15,53,11,23,3,3,50,8,3,3406.0,10356.211,0.005401134490966797,0.0017080307006835938,0.0,39643.789000000004
192,14:50:30,1,1000,400,14,15,53,11,23,3,3,50,8,3,3406.0,10356.211,0.005179166793823242,0.0016601085662841797,0.0,39643.789000000004
192,14:50:30,1,1000,500,14,15,53,11,23,3,3,50,8,3,3406.0,10356.211,0.004965066909790039,0.0018460750579833984,0.0,39643.789000000004
192,14:50:30,1,1000,600,14,15,53,11,23,3,3,50,8,3,3406.0,10356.211,0.004891872406005859,0.001667022705078125,0.0,39643.789000000004
192,14:50:30,1,1000,700,14,15,53,11,23,3,3,50,8,3,3406.0,10356.211,0.005012035369873047,0.001619100570678711,0.0,39643.789000000004
187,16:47:00,0.4,1000,0,12,13,2,2,15,0,0,2,2,0,5442.0,12292.935000000001,0.0005638599395751953,0.0007808208465576172,0.0,-10292.935000000001
187,16:47:00,0.4,1000,100,12,13,13,7,18,2,2,11,5,2,4785.0,12960.712974012002,0.0029458999633789062,0.001569986343383789,0.0,-1960.7129740120017
187,16:47:00,0.4,1000,200,12,13,27,15,23,5,5,22,10,5,5442.0,14026.992999999997,0.005336761474609375,0.004568815231323242,0.0,7973.007000000003
187,16:47:00,0.4,1000,300,12,13,37,19,26,6,6,31,13,6,4785.0,15004.518999999995,0.007593870162963867,0.007803916931152344,0.0,15995.481000000005
187,16:47:00,0.4,1000,400,12,13,41,20,27,6,6,35,14,6,4785.0,16799.511000000002,0.009282112121582031,0.0060770511627197266,0.0,18200.488999999998
187,16:47:00,0.4,1000,500,12,13,43,21,28,6,6,37,15,6,4785.0,17568.203,0.00966501235961914,0.007506132125854492,0.0,19431.797
187,16:47:00,0.4,1000,600,12,13,43,21,28,6,6,37,15,6,4785.0,17568.203,0.00937795639038086,0.007316112518310547,0.0,19431.797
187,16:47:00,0.4,1000,700,12,13,43,21,28,6,6,37,15,6,4785.0,17568.203,0.009490013122558594,0.00817108154296875,0.0,19431.797
187,13:47:00,1,1000,0,29,30,5,0,30,0,0,5,0,0,5546.0,12328.012,0.002415895462036133,0.0005080699920654297,0.0,-7328.012000000001
187,13:47:00,1,1000,100,29,30,14,2,32,0,0,14,2,0,5367.0,12695.605,0.002270936965942383,0.0007560253143310547,0.0,1304.3950000000004
187,13:47:00,1,1000,200,29,30,23,8,36,2,2,21,6,2,5367.0,13178.236999999997,0.003286123275756836,0.0011320114135742188,0.0,7821.763000000003
187,13:47:00,1,1000,300,29,30,33,10,38,2,2,31,8,2,5367.0,13772.442999999996,0.00456690788269043,0.0015139579772949219,0.0,17227.557000000004
187,13:47:00,1,1000,400,29,30,35,10,38,2,2,33,8,2,5367.0,13772.442999999996,0.004820108413696289,0.0016829967498779297,0.0,19227.557000000004
187,13:47:00,1,1000,500,29,30,38,12,39,3,3,35,9,3,5367.0,14648.649999999998,0.005568981170654297,0.002721071243286133,0.0,20351.350000000002
187,13:47:00,1,1000,600,29,30,38,12,39,3,3,35,9,3,5367.0,14648.649999999998,0.005295276641845703,0.002480030059814453,0.0,20351.350000000002
187,13:47:00,1,1000,700,29,30,38,12,39,3,3,35,9,3,5367.0,14648.649999999998,0.005541801452636719,0.0029380321502685547,0.0,20351.350000000002
185,07:21:00,0.2,1000,0,5,6,20,13,17,2,2,18,11,2,5359.0,12369.862000000003,0.004464864730834961,0.0030050277709960938,0.0,5630.137999999997
185,07:21:00,0.2,1000,100,5,6,40,23,27,2,2,38,21,2,3725.0,13547.886999999982,0.0118560791015625,0.005076169967651367,0.0,24452.11300000002
185,07:21:00,0.2,1000,200,5,6,77,37,37,6,7,70,31,6,5359.0,18276.931,0.045168161392211914,0.06389617919921875,0.0,51723.069
185,07:21:00,0.2,1000,300,5,6,88,39,38,7,7,81,32,7,4997.875723276065,18977.163,0.055574893951416016,0.11654210090637207,0.0,62022.837
185,07:21:00,0.2,1000,400,5,6,89,39,39,6,7,82,33,6,4985.909873836536,19104.867000000002,0.05489611625671387,0.06007885932922363,0.0,62895.133
185,07:21:00,0.2,1000,500,5,6,89,39,39,6,7,82,33,6,4985.909873836536,19104.867000000002,0.05524110794067383,0.05924820899963379,0.0,62895.133
185,07:21:00,0.2,1000,600,5,6,89,39,39,6,7,82,33,6,4985.909873836536,19104.867000000002,0.05695009231567383,0.06605291366577148,0.0,62895.133
185,07:21:00,0.2,1000,700,5,6,89,39,39,6,7,82,33,6,4985.909873836536,19104.867000000002,0.05553078651428223,0.059745073318481445,0.0,62895.133
191,13:41:30,0.4,1000,0,6,7,3,2,7,2,3,0,0,2,2533.0,5095.779684128705,0.0004050731658935547,0.0004830360412597656,0.0,-5095.779684128705
191,13:41:30,0.4,1000,100,6,7,11,4,8,3,6,5,1,3,2052.315997077072,7448.933684128705,0.0009028911590576172,0.0010499954223632812,0.0,-2448.933684128705
191,13:41:30,0.4,1000,200,6,7,22,7,8,6,13,9,1,6,2052.315997077072,7448.933684128675,0.0019431114196777344,0.005081892013549805,0.0,1551.066315871276
191,13:41:30,0.4,1000,300,6,7,22,7,8,6,13,9,1,6,2052.315997077072,7448.933684128675,0.001934051513671875,0.004103899002075195,0.0,1551.066315871276
191,13:41:30,0.4,1000,400,6,7,23,8,8,7,14,9,1,7,2048.916234192271,7448.933684128705,0.002235889434814453,0.011363983154296875,0.0,1551.066315871295
191,13:41:30,0.4,1000,500,6,7,23,8,8,7,14,9,1,7,2048.916234192271,7448.933684128705,0.0022993087768554688,0.011697053909301758,0.0,1551.066315871295
191,13:41:30,0.4,1000,600,6,7,23,8,8,7,14,9,1,7,2048.916234192271,7448.933684128705,0.002325296401977539,0.010586977005004883,0.0,1551.066315871295
191,13:41:30,0.4,1000,700,6,7,23,8,8,7,14,9,1,7,2048.916234192271,7448.933684128705,0.0022690296173095703,0.0103759765625,0.0,1551.066315871295
187,13:47:00,0,1000,0,1,2,4,5,5,2,1,3,3,2,1404.1388168098347,5380.338999999999,0.0005328655242919922,0.0006830692291259766,0.0,-2380.338999999999
187,13:47:00,0,1000,100,1,2,7,8,6,4,3,4,4,4,1404.1388168098274,5380.338999999999,0.001348257064819336,0.0009629726409912109,0.0,-1380.338999999999
187,13:47:00,0,1000,200,1,2,18,17,10,9,6,12,8,9,3369.0,6111.8369999999995,0.009645938873291016,0.005782127380371094,0.0,5888.1630000000005
187,13:47:00,0,1000,300,1,2,27,24,20,6,5,22,18,6,2532.57512377714,9704.249,0.025504112243652344,0.11361193656921387,0.0,12295.751
187,13:47:00,0,1000,400,1,2,34,27,26,3,3,31,24,3,3369.0,12508.975999999997,0.039834022521972656,0.06428098678588867,0.0,18491.024000000005
187,13:47:00,0,1000,500,1,2,38,30,28,4,5,33,26,4,3369.0,12508.975999999997,0.0541379451751709,0.11171603202819824,0.0,20491.024000000005
187,13:47:00,0,1000,600,1,2,38,30,28,4,5,33,26,4,3369.0,12508.975999999997,0.05469322204589844,0.11454892158508301,0.0,20491.024000000005
187,13:47:00,0,1000,700,1,2,38,30,28,4,5,33,26,4,3369.0,12508.975999999997,0.05300498008728027,0.11115097999572754,0.0,20491.024000000005
191,07:22:00,0.4,1000,0,5,6,5,2,8,0,0,5,2,0,2549.0,5594.90073489609,0.00039505958557128906,0.0004909038543701172,0.0,-594.9007348960904
191,07:22:00,0.4,1000,100,5,6,15,6,12,0,0,15,6,0,1939.0,6193.904734896091,0.001107931137084961,0.0006728172302246094,0.0,8806.095265103908
191,07:22:00,0.4,1000,200,5,6,29,11,16,1,1,28,10,1,2175.0859186453345,7911.491734896093,0.0029172897338867188,0.0009849071502685547,0.0,20088.50826510391
191,07:22:00,0.4,1000,300,5,6,31,12,17,1,1,30,11,1,2406.1378006544037,8796.82973489609,0.003726959228515625,0.0014889240264892578,0.0,21203.17026510391
191,07:22:00,0.4,1000,400,5,6,31,12,17,1,1,30,11,1,2406.1378006544037,8796.82973489609,0.0038940906524658203,0.001535177230834961,0.0,21203.17026510391
191,07:22:00,0.4,1000,500,5,6,31,12,17,1,1,30,11,1,2406.1378006544037,8796.82973489609,0.0036096572875976562,0.0014400482177734375,0.0,21203.17026510391
191,07:22:00,0.4,1000,600,5,6,31,12,17,1,1,30,11,1,2406.1378006544037,8796.82973489609,0.00362396240234375,0.0014581680297851562,0.0,21203.17026510391
191,07:22:00,0.4,1000,700,5,6,31,12,17,1,1,30,11,1,2406.1378006544037,8796.82973489609,0.0036668777465820312,0.0014109611511230469,0.0,21203.17026510391
199,16:04:00,0.2,1000,0,4,5,0,0,5,0,0,0,0,0,3075.0,9214.038,0.00018930435180664062,0.0003581047058105469,0.0,-9214.038
199,16:04:00,0.2,1000,100,4,5,7,5,7,3,4,3,2,3,3075.0,9545.682,0.0006511211395263672,0.0006048679351806641,0.0,-6545.682000000001
199,16:04:00,0.2,1000,200,4,5,16,15,13,7,7,9,8,7,5097.0,11704.804,0.0030257701873779297,0.0065419673919677734,0.0,-2704.804
199,16:04:00,0.2,1000,300,4,5,25,20,18,7,13,12,13,7,3435.518551658308,12522.215999999999,0.007337093353271484,0.017116069793701172,0.0,-522.2159999999985
199,16:04:00,0.2,1000,400,4,5,27,20,18,7,13,14,13,7,3435.518551658308,12522.215999999999,0.00768280029296875,0.015356063842773438,0.0,1477.7840000000015
199,16:04:00,0.2,1000,500,4,5,27,20,18,7,13,14,13,7,3435.518551658308,12522.215999999999,0.00780797004699707,0.015398025512695312,0.0,1477.7840000000015
199,16:04:00,0.2,1000,600,4,5,43,21,17,9,29,14,12,9,3435.518551658308,12522.215999999999,0.011562108993530273,0.011160135269165039,0.0,1477.7840000000015
199,16:04:00,0.2,1000,700,4,5,43,21,17,9,29,14,12,9,3435.518551658308,12522.215999999999,0.011458158493041992,0.011099100112915039,0.0,1477.7840000000015
195,13:21:00,0.4,1000,0,9,10,8,6,16,0,0,8,6,0,3144.0,9493.405,0.0008518695831298828,0.0008120536804199219,0.0,-1493.4050000000007
195,13:21:00,0.4,1000,100,9,10,16,13,23,0,0,16,13,0,3350.9693614292555,12005.726999999997,0.0034112930297851562,0.0011708736419677734,0.0,3994.273000000003
195,13:21:00,0.4,1000,200,9,10,34,19,27,2,2,32,17,2,3503.0,12552.541999999998,0.007687807083129883,0.02203512191772461,0.0,19447.458000000002
195,13:21:00,0.4,1000,300,9,10,39,23,28,5,5,34,18,5,3454.107768134105,12934.312999999998,0.011121749877929688,0.020385026931762695,0.0,21065.686999999994
195,13:21:00,0.4,1000,400,9,10,39,23,28,5,5,34,18,5,3454.107768134105,12934.312999999998,0.01098012924194336,0.01936197280883789,0.0,21065.686999999994
195,13:21:00,0.4,1000,500,9,10,40,25,28,7,6,34,18,7,3454.107768134105,12934.312999999998,0.01338815689086914,0.02327704429626465,0.0,21065.687
195,13:21:00,0.4,1000,600,9,10,40,25,28,7,6,34,18,7,3454.107768134105,12934.312999999998,0.014014959335327148,0.024350881576538086,0.0,21065.687
195,13:21:00,0.4,1000,700,9,10,40,25,28,7,6,34,18,7,3454.107768134105,12934.312999999998,0.013416051864624023,0.023726940155029297,0.0,21065.687
194,07:10:00,0.4,1000,0,9,10,5,6,13,3,2,3,3,3,2941.8054461942265,8902.798999999999,0.0008409023284912109,0.0009479522705078125,0.0,-5902.798999999999
194,07:10:00,0.4,1000,100,9,10,31,12,16,6,8,23,6,6,3334.334541278935,9330.152999999998,0.0055332183837890625,0.023012876510620117,0.0,13669.847000000002
194,07:10:00,0.4,1000,200,9,10,49,18,19,9,18,31,9,9,3393.39390956812,9556.454999999998,0.014455080032348633,0.10273599624633789,0.0,21443.545000000002
194,07:10:00,0.4,1000,300,9,10,50,18,19,9,19,31,9,9,4287.0,9330.152999999998,0.014333009719848633,0.11556601524353027,0.0,21669.847
194,07:10:00,0.4,1000,400,9,10,51,19,19,10,19,32,9,10,3334.3345412789313,9517.487999999998,0.014400005340576172,0.08187103271484375,0.0,22482.512000000002
194,07:10:00,0.4,1000,500,9,10,51,19,19,10,19,32,9,10,3334.3345412789313,9517.487999999998,0.014299869537353516,0.08217096328735352,0.0,22482.512000000002
194,07:10:00,0.4,1000,600,9,10,51,19,19,10,19,32,9,10,3334.3345412789313,9517.487999999998,0.01392984390258789,0.07910895347595215,0.0,22482.512000000002
194,07:10:00,0.4,1000,700,9,10,51,19,19,10,19,32,9,10,3334.3345412789313,9517.487999999998,0.014220952987670898,0.08224201202392578,0.0,22482.512000000002
192,14:50:30,0,1000,0,1,2,5,5,7,0,0,5,5,0,1734.7237756502,6647.065,0.0006129741668701172,0.00327301025390625,0.0,-1647.0649999999996
192,14:50:30,0,1000,100,1,2,26,14,16,0,0,26,14,0,2140.7448625029865,8202.845000000001,0.009493827819824219,0.002053976058959961,0.0,17797.155
192,14:50:30,0,1000,200,1,2,46,19,21,0,0,46,19,0,2507.0,9099.894000000002,0.02753734588623047,0.008821964263916016,0.0,36900.106
192,14:50:30,0,1000,300,1,2,53,24,23,3,3,50,21,3,2507.0,9600.11,0.04841303825378418,0.016828060150146484,0.0,40399.89
192,14:50:30,0,1000,400,1,2,53,24,23,3,3,50,21,3,2507.0,9600.11,0.0469210147857666,0.015725135803222656,0.0,40399.89
192,14:50:30,0,1000,500,1,2,53,24,23,3,3,50,21,3,2507.0,9600.11,0.04642605781555176,0.01615595817565918,0.0,40399.89
192,14:50:30,0,1000,600,1,2,53,24,23,3,3,50,21,3,2507.0,9600.11,0.04811406135559082,0.016087055206298828,0.0,40399.89
192,14:50:30,0,1000,700,1,2,53,24,23,3,3,50,21,3,2507.0,9600.11,0.04742693901062012,0.01662898063659668,0.0,40399.89
185,07:21:00,0,1000,0,1,2,10,11,13,0,0,10,11,0,3146.663423109043,12057.295,0.0031349658966064453,0.0013720989227294922,0.0,-2057.295
185,07:21:00,0,1000,100,1,2,39,27,29,0,0,39,27,0,3763.525113338106,14420.968,0.04490303993225098,0.006118059158325195,0.0,24579.032
185,07:21:00,0,1000,200,1,2,78,43,44,1,2,76,42,1,4731.311963135289,18129.306000000004,0.21343421936035156,0.012828826904296875,0.0,57870.693999999996
185,07:21:00,0,1000,300,1,2,88,45,46,1,2,86,44,1,4967.457572774994,19034.162000000004,0.2575840950012207,0.02339315414428711,0.0,66965.83799999999
185,07:21:00,0,1000,400,1,2,89,45,46,1,2,87,44,1,4967.457572774994,19034.162000000004,0.2610459327697754,0.02157902717590332,0.0,67965.83799999999
185,07:21:00,0,1000,500,1,2,89,45,46,1,2,87,44,1,4967.457572774994,19034.162000000004,0.2648758888244629,0.0214080810546875,0.0,67965.83799999999
185,07:21:00,0,1000,600,1,2,89,45,46,1,2,87,44,1,4967.457572774994,19034.162000000004,0.2587909698486328,0.02085113525390625,0.0,67965.83799999999
185,07:21:00,0,1000,700,1,2,89,45,46,1,2,87,44,1,4967.457572774994,19034.162000000004,0.2648918628692627,0.021587133407592773,0.0,67965.83799999999
196,09:57:30,0,1000,0,1,2,1,1,2,1,1,0,0,1,364.61334556192014,1397.115,0.00016379356384277344,0.0004570484161376953,0.0,-1397.115
196,09:57:30,0,1000,100,1,2,5,5,2,5,5,0,0,5,875.0,1397.115,0.0006120204925537109,0.0008471012115478516,0.0,-1397.115
196,09:57:30,0,1000,200,1,2,6,6,2,6,6,0,0,6,875.0,1397.115,0.0007989406585693359,0.0010671615600585938,0.0,-1397.115
196,09:57:30,0,1000,300,1,2,15,10,4,8,13,2,2,8,875.0,2883.167,0.003355741500854492,0.0039060115814208984,0.0,-883.1669999999999
196,09:57:30,0,1000,400,1,2,15,10,4,8,13,2,2,8,875.0,2883.167,0.003506183624267578,0.00395512580871582,0.0,-883.1669999999999
196,09:57:30,0,1000,500,1,2,15,10,4,8,13,2,2,8,875.0,2883.167,0.003422975540161133,0.0039119720458984375,0.0,-883.1669999999999
196,09:57:30,0,1000,600,1,2,15,10,4,8,13,2,2,8,875.0,2883.167,0.0034492015838623047,0.003589153289794922,0.0,-883.1669999999999
196,09:57:30,0,1000,700,1,2,15,10,4,8,13,2,2,8,875.0,2883.167,0.003354787826538086,0.0036580562591552734,0.0,-883.1669999999999
193,13:30:30,0,1000,0,1,2,6,7,9,0,0,6,7,0,1711.0968444285463,6556.531999999999,0.0011491775512695312,0.0007960796356201172,0.0,-556.5319999999992
193,13:30:30,0,1000,100,1,2,24,14,16,0,0,24,14,0,1892.0802389047967,7250.019,0.00884699821472168,0.0018050670623779297,0.0,16749.981
193,13:30:30,0,1000,200,1,2,40,20,22,0,0,40,20,0,2420.812716237182,9276.000999999998,0.026082992553710938,0.0035979747772216797,0.0,30723.999000000003
193,13:30:30,0,1000,300,1,2,47,21,22,1,1,46,20,1,2420.812716237182,9276.000999999998,0.03366684913635254,0.004053831100463867,0.0,36723.999
193,13:30:30,0,1000,400,1,2,48,21,22,1,1,47,20,1,2420.812716237182,9276.000999999998,0.033618927001953125,0.003977060317993164,0.0,37723.999
193,13:30:30,0,1000,500,1,2,48,21,22,1,1,47,20,1,2420.812716237182,9276.000999999998,0.03382396697998047,0.004625082015991211,0.0,37723.999
193,13:30:30,0,1000,600,1,2,48,21,22,1,1,47,20,1,2420.812716237182,9276.000999999998,0.03349924087524414,0.003956794738769531,0.0,37723.999
193,13:30:30,0,1000,700,1,2,48,21,22,1,1,47,20,1,2420.812716237182,9276.000999999998,0.033854007720947266,0.003977060317993164,0.0,37723.999
185,07:21:00,0.4,1000,0,11,12,26,13,20,5,14,12,8,5,4224.731657122382,13701.460000000001,0.0041310787200927734,0.008330106735229492,0.0,-1701.460000000001
185,07:21:00,0.4,1000,100,11,12,42,19,24,7,22,20,12,7,4380.094786447149,14972.553999999998,0.008266925811767578,0.03208208084106445,0.0,5027.446000000002
185,07:21:00,0.4,1000,200,11,12,77,30,30,12,39,38,18,12,5253.0,17234.769,0.029298067092895508,0.12939691543579102,0.0,20765.231
185,07:21:00,0.4,1000,300,11,12,88,32,31,13,43,45,19,13,5253.0,17935.235,0.034475088119506836,0.3136258125305176,0.0,27064.765
185,07:21:00,0.4,1000,400,11,12,89,32,33,11,43,46,21,11,5253.0,18245.326999999997,0.041481971740722656,0.2616920471191406,0.0,27754.673000000003
185,07:21:00,0.4,1000,500,11,12,89,32,33,11,43,46,21,11,5253.0,18245.326999999997,0.033731937408447266,0.24047517776489258,0.0,27754.673000000003
185,07:21:00,0.4,1000,600,11,12,89,32,33,11,43,46,21,11,5253.0,18245.326999999997,0.03274679183959961,0.24818706512451172,0.0,27754.673000000003
185,07:21:00,0.4,1000,700,11,12,89,32,33,11,43,46,21,11,5253.0,18245.326999999997,0.033622026443481445,0.24075603485107422,0.0,27754.673000000003
191,13:41:30,0.2,1000,0,3,4,3,3,5,2,2,1,1,2,2956.0,5338.725684128705,0.0003421306610107422,0.00037384033203125,0.0,-4338.725684128705
191,13:41:30,0.2,1000,100,3,4,10,6,6,4,7,3,2,4,2956.0,5655.455684128705,0.0009839534759521484,0.0007419586181640625,0.0,-2655.455684128705
191,13:41:30,0.2,1000,200,3,4,21,10,8,6,15,6,4,6,2956.0,5883.4766841287055,0.0025429725646972656,0.0014400482177734375,0.0,116.52331587129447
191,13:41:30,0.2,1000,300,3,4,23,11,9,6,15,8,5,6,2956.0,5883.4766841287055,0.0030329227447509766,0.0021657943725585938,0.0,2116.5233158712945
191,13:41:30,0.2,1000,400,3,4,23,11,9,6,15,8,5,6,2956.0,5883.4766841287055,0.0029921531677246094,0.0017468929290771484,0.0,2116.5233158712945
191,13:41:30,0.2,1000,500,3,4,23,11,9,6,15,8,5,6,2956.0,5883.4766841287055,0.0029909610748291016,0.0016219615936279297,0.0,2116.5233158712945
191,13:41:30,0.2,1000,600,3,4,23,11,9,6,15,8,5,6,2956.0,5883.4766841287055,0.0030260086059570312,0.0016291141510009766,0.0,2116.5233158712945
191,13:41:30,0.2,1000,700,3,4,23,11,9,6,15,8,5,6,2956.0,5883.4766841287055,0.0029020309448242188,0.0022859573364257812,0.0,2116.5233158712945
193,13:30:30,0.4,1000,0,6,7,4,5,9,3,3,1,2,3,2343.0,5708.795999999999,0.0005152225494384766,0.0006051063537597656,0.0,-4708.795999999999
193,13:30:30,0.4,1000,100,6,7,21,11,14,4,10,11,7,4,2453.2305162848934,8913.961,0.0024209022521972656,0.008075952529907227,4.793769312528207e-10,2086.0390000000007
193,13:30:30,0.4,1000,200,6,7,40,16,16,7,17,23,9,7,2464.0,9320.221999999998,0.00590205192565918,0.03137087821960449,0.0,13679.778000000002
193,13:30:30,0.4,1000,300,6,7,46,17,16,8,18,28,9,8,2464.0,9320.221999999989,0.0072519779205322266,0.023869991302490234,0.0,18679.778000000006
193,13:30:30,0.4,1000,400,6,7,48,17,16,8,18,30,9,8,2464.0,9320.221999999998,0.007369041442871094,0.030514001846313477,0.0,20679.778000000002
193,13:30:30,0.4,1000,500,6,7,48,17,16,8,18,30,9,8,2464.0,9320.221999999998,0.008237123489379883,0.03811502456665039,0.0,20679.778000000002
193,13:30:30,0.4,1000,600,6,7,48,17,16,8,18,30,9,8,2464.0,9320.221999999998,0.007433891296386719,0.029659032821655273,0.0,20679.778000000002
193,13:30:30,0.4,1000,700,6,7,48,17,16,8,18,30,9,8,2464.0,9320.221999999998,0.007427215576171875,0.03081202507019043,0.0,20679.778000000002
199,13:24:30,0.4,1000,0,8,9,6,3,12,0,1,5,3,0,3750.0,12052.299,0.0005979537963867188,0.000576019287109375,0.0,-7052.299000000001
199,13:24:30,0.4,1000,100,8,9,14,8,16,1,2,12,7,1,3750.0,12835.941,0.0016891956329345703,0.0008971691131591797,0.0,-835.9410000000007
199,13:24:30,0.4,1000,200,8,9,17,12,18,3,3,14,9,3,3750.0,13648.051000000001,0.0024750232696533203,0.002705097198486328,0.0,351.9489999999987
199,13:24:30,0.4,1000,300,8,9,21,14,21,2,3,18,12,2,5688.0,14246.774000000001,0.0033512115478515625,0.002228975296020508,0.0,3753.2259999999987
199,13:24:30,0.4,1000,400,8,9,21,14,21,2,3,18,12,2,5688.0,14246.774000000001,0.003307819366455078,0.002332925796508789,0.0,3753.2259999999987
199,13:24:30,0.4,1000,500,8,9,22,14,21,2,4,18,12,2,5688.0,14246.774000000001,0.0041730403900146484,0.0021758079528808594,0.0,3753.2259999999987
199,13:24:30,0.4,1000,600,8,9,27,14,21,2,4,23,12,2,3756.651119959446,14246.774000000001,0.003957271575927734,0.002797842025756836,0.0,8753.225999999999
199,13:24:30,0.4,1000,700,8,9,29,16,23,2,4,25,14,2,3882.977809591983,14730.829000000003,0.005327939987182617,0.0029211044311523438,0.0,10269.170999999997
199,13:24:30,1,1000,0,19,20,8,2,22,0,1,7,2,0,4871.0,11545.71,0.0012488365173339844,0.0006458759307861328,0.0,-4545.709999999999
199,13:24:30,1,1000,100,19,20,23,5,23,2,3,20,3,2,4871.0,11607.46,0.0022029876708984375,0.0008230209350585938,0.0,8392.54
199,13:24:30,1,1000,200,19,20,28,9,25,4,5,23,5,4,4871.0,12080.197,0.003203868865966797,0.001138925552368164,0.0,10919.803
199,13:24:30,1,1000,300,19,20,30,10,26,4,5,25,6,4,4871.0,12604.350999999999,0.0035169124603271484,0.0011570453643798828,0.0,12395.649000000001
199,13:24:30,1,1000,400,19,20,30,10,26,4,5,25,6,4,4871.0,12604.350999999999,0.003475189208984375,0.0011701583862304688,0.0,12395.649000000001
199,13:24:30,1,1000,500,19,20,30,10,26,4,5,25,6,4,4871.0,12604.350999999999,0.003381967544555664,0.0011069774627685547,0.0,12395.649000000001
199,13:24:30,1,1000,600,19,20,30,10,26,4,5,25,6,4,4871.0,12604.350999999999,0.003397226333618164,0.0011179447174072266,0.0,12395.649000000001
199,13:24:30,1,1000,700,19,20,30,10,26,4,5,25,6,4,4871.0,12604.350999999999,0.0039370059967041016,0.0011620521545410156,0.0,12395.649000000001
187,16:47:00,0.2,1000,0,6,7,2,2,9,0,0,2,2,0,5325.0,12028.034000000001,0.00034689903259277344,0.000576019287109375,0.0,-10028.034000000001
187,16:47:00,0.2,1000,100,6,7,10,6,13,0,0,10,6,0,4668.0,12921.731,0.001055002212524414,0.0007519721984863281,0.0,-2921.7309999999998
187,16:47:00,0.2,1000,200,6,7,22,17,22,2,2,20,15,2,4668.0,14157.467999999997,0.005374431610107422,0.0014891624450683594,0.0,5842.532000000003
187,16:47:00,0.2,1000,300,6,7,33,20,26,1,1,32,19,1,4668.0,16183.170999999997,0.007242918014526367,0.0018260478973388672,0.0,15816.829000000003
187,16:47:00,0.2,1000,400,6,7,40,23,28,2,2,38,21,2,5325.0,16783.929999999997,0.01045083999633789,0.006874799728393555,0.0,21216.070000000003
187,16:47:00,0.2,1000,500,6,7,43,26,31,2,2,41,24,2,4835.470107074689,18376.989,0.012536048889160156,0.014662981033325195,0.0,22623.011
187,16:47:00,0.2,1000,600,6,7,43,26,31,2,2,41,24,2,4835.470107074689,18376.989,0.01250910758972168,0.014925003051757812,0.0,22623.011
187,16:47:00,0.2,1000,700,6,7,43,26,31,2,2,41,24,2,4835.470107074689,18376.989,0.012270689010620117,0.014520883560180664,0.0,22623.011
55,15:58:00,1,1000,0,22,23,15,3,24,2,1,14,1,2,6655.0,15989.469000000001,0.0016241073608398438,0.0007951259613037109,0.0,-1989.469000000001
55,15:58:00,1,1000,100,22,23,33,8,27,4,3,30,4,4,6771.284217668814,17140.995,0.003944873809814453,0.0009839534759521484,0.0,12859.005000000001
55,15:58:00,1,1000,200,22,23,54,14,29,8,8,46,6,8,6771.284217668814,18242.193,0.007828235626220703,0.0015981197357177734,0.0,27757.807
55,15:58:00,1,1000,300,22,23,64,18,30,11,13,51,7,11,6750.198930744453,18364.22,0.010126113891601562,0.0035970211029052734,8.637758925949198e-05,32635.78
55,15:58:00,1,1000,400,22,23,70,18,30,11,18,52,7,11,6750.198930744453,18364.22,0.01191091537475586,0.0033240318298339844,8.380956231736393e-05,33635.78
55,15:58:00,1,1000,500,22,23,71,18,30,11,19,52,7,11,6750.198930744453,18364.22,0.011514902114868164,0.0034608840942382812,8.380956231736393e-05,33635.78
55,15:58:00,1,1000,600,22,23,71,18,30,11,19,52,7,11,6750.198930744453,18364.22,0.011221885681152344,0.0035490989685058594,8.380956231736393e-05,33635.78
55,15:58:00,1,1000,700,22,23,71,18,30,11,19,52,7,11,6750.198930744453,18364.22,0.011275053024291992,0.0034689903259277344,8.380956231736393e-05,33635.78
187,16:47:00,1,1000,0,29,30,7,0,30,0,0,7,0,0,5546.0,12328.012,0.00220489501953125,0.0004630088806152344,0.0,-5328.012000000001
187,16:47:00,1,1000,100,29,30,13,2,31,1,1,12,1,1,5367.0,12769.466,0.0021791458129882812,0.0006968975067138672,0.0,-769.4660000000003
187,16:47:00,1,1000,200,29,30,29,8,35,3,3,26,5,3,5367.0,13553.770999999999,0.0036017894744873047,0.0009911060333251953,0.0,12446.229000000001
187,16:47:00,1,1000,300,29,30,41,9,35,4,4,37,5,4,5367.0,13553.770999999999,0.0047607421875,0.0008978843688964844,0.0,23446.229
187,16:47:00,1,1000,400,29,30,41,9,35,4,4,37,5,4,5367.0,13553.770999999999,0.0046749114990234375,0.0009069442749023438,0.0,23446.229
187,16:47:00,1,1000,500,29,30,43,10,36,4,4,39,6,4,5367.0,14322.462999999998,0.005174160003662109,0.001252889633178711,0.0,24677.537000000004
187,16:47:00,1,1000,600,29,30,43,10,36,4,4,39,6,4,5367.0,14322.462999999998,0.005202054977416992,0.0012938976287841797,0.0,24677.537000000004
187,16:47:00,1,1000,700,29,30,43,10,36,4,4,39,6,4,5367.0,14322.462999999998,0.005909919738769531,0.001316070556640625,0.0,24677.537000000004
185,15:27:00,0.2,1000,0,3,4,4,3,5,2,1,3,1,2,3860.0,7603.9259999999995,0.0003237724304199219,0.0004508495330810547,0.0,-4603.9259999999995
185,15:27:00,0.2,1000,100,3,4,8,6,8,2,1,7,4,2,2327.0,7905.697999999999,0.0007460117340087891,0.0006120204925537109,0.0,-905.6979999999994
185,15:27:00,0.2,1000,200,3,4,22,16,17,3,3,19,13,3,2442.8972798854666,9360.624,0.006761074066162109,0.003023862838745117,0.0,9639.376
185,15:27:00,0.2,1000,300,3,4,26,20,20,4,4,22,16,4,3860.0,11010.146,0.010123014450073242,0.008375883102416992,0.0,10989.854
185,15:27:00,0.2,1000,400,3,4,26,20,20,4,4,22,16,4,3860.0,11010.146,0.010066986083984375,0.008234024047851562,0.0,10989.854
185,15:27:00,0.2,1000,500,3,4,26,20,20,4,4,22,16,4,3860.0,11010.146,0.010082006454467773,0.00839996337890625,0.0,10989.854
185,15:27:00,0.2,1000,600,3,4,26,20,20,4,4,22,16,4,3860.0,11010.146,0.010303020477294922,0.008620977401733398,0.0,10989.854
185,15:27:00,0.2,1000,700,3,4,26,20,20,4,4,22,16,4,3860.0,11010.146,0.010434865951538086,0.008625030517578125,0.0,10989.854
192,08:28:00,0.4,1000,0,5,6,5,4,10,0,0,5,4,0,2485.337665533283,7518.242,0.00048613548278808594,0.0006361007690429688,0.0,-2518.242
192,08:28:00,0.4,1000,100,5,6,16,10,16,0,0,16,10,0,2586.953069076597,9582.584000000003,0.00168609619140625,0.0015158653259277344,0.0,6417.415999999997
192,08:28:00,0.4,1000,200,5,6,26,13,19,0,0,26,13,0,2783.105986041519,10664.225999999999,0.0034711360931396484,0.001692056655883789,0.0,15335.774000000001
192,08:28:00,0.4,1000,300,5,6,30,15,20,1,1,29,14,1,2906.015613815318,10726.819,0.004751920700073242,0.004220008850097656,0.0,18273.180999999975
192,08:28:00,0.4,1000,400,5,6,33,16,21,1,1,32,15,1,2906.015613815318,11130.926,0.005639076232910156,0.0038089752197265625,0.0,20869.074
192,08:28:00,0.4,1000,500,5,6,33,16,21,1,1,32,15,1,2906.015613815318,11130.926,0.005712985992431641,0.0040819644927978516,0.0,20869.074
192,08:28:00,0.4,1000,600,5,6,33,16,21,1,1,32,15,1,2906.015613815318,11130.926,0.005603790283203125,0.0038709640502929688,0.0,20869.074
192,08:28:00,0.4,1000,700,5,6,33,16,21,1,1,32,15,1,2906.015613815318,11130.926,0.0055010318756103516,0.003771066665649414,0.0,20869.074
55,18:56:00,1,1000,0,27,28,17,0,28,0,0,17,0,0,8510.0,19058.935,0.0017819404602050781,0.0004611015319824219,0.0,-2058.9350000000013
55,18:56:00,1,1000,100,27,28,29,2,30,0,0,29,2,0,8372.0,19822.577,0.0029370784759521484,0.0006330013275146484,0.0,9177.422999999999
55,18:56:00,1,1000,200,27,28,40,6,33,1,1,39,5,1,8422.927433786681,21127.759000000002,0.0037522315979003906,0.0008261203765869141,0.0,17872.240999999998
55,18:56:00,1,1000,300,27,28,50,12,37,3,2,48,9,3,8422.927433786681,22370.847,0.0064580440521240234,0.0014710426330566406,0.0,25629.153
55,18:56:00,1,1000,400,27,28,55,14,38,4,3,52,10,4,8422.927433786681,22652.821000000004,0.007620811462402344,0.002146005630493164,0.0,29347.178999999996
55,18:56:00,1,1000,500,27,28,58,15,39,4,3,55,11,4,8422.927433786681,23161.205,0.008230209350585938,0.0019190311431884766,0.0,31838.795
55,18:56:00,1,1000,600,27,28,58,15,39,4,3,55,11,4,8422.927433786681,23161.205,0.008137941360473633,0.001878976821899414,0.0,31838.795
55,18:56:00,1,1000,700,27,28,58,15,39,4,3,55,11,4,8422.927433786681,23161.205,0.008092164993286133,0.001767873764038086,0.0,31838.795
193,08:16:30,0.4,1000,0,5,6,13,4,10,0,0,13,4,0,1852.802866261034,6902.593000000001,0.0007219314575195312,0.0005490779876708984,0.0,6097.406999999999
193,08:16:30,0.4,1000,100,5,6,25,9,14,1,1,24,8,1,2019.5341058219965,7603.015000000001,0.002546072006225586,0.0011889934539794922,0.0,16396.985
193,08:16:30,0.4,1000,200,5,6,41,15,19,2,3,38,13,2,2405.0035716416132,9072.551999999998,0.007297039031982422,0.00273895263671875,0.0,28927.448000000004
193,08:16:30,0.4,1000,300,5,6,42,16,19,3,4,38,13,3,2648.0,9072.551999999998,0.007194995880126953,0.0042040348052978516,0.0,28927.448000000004
193,08:16:30,0.4,1000,400,5,6,43,16,19,3,4,39,13,3,2648.0,9072.551999999998,0.00737309455871582,0.003981113433837891,0.0,29927.448000000004
193,08:16:30,0.4,1000,500,5,6,43,16,19,3,4,39,13,3,2648.0,9072.551999999998,0.0072820186614990234,0.003827810287475586,0.0,29927.448000000004
193,08:16:30,0.4,1000,600,5,6,43,16,19,3,4,39,13,3,2648.0,9072.551999999998,0.007459163665771484,0.00409698486328125,0.0,29927.448000000004
193,08:16:30,0.4,1000,700,5,6,43,16,19,3,4,39,13,3,2648.0,9072.551999999998,0.0076639652252197266,0.004539966583251953,0.0,29927.448000000004
198,19:44:00,1,1000,0,7,8,2,1,9,0,0,2,1,0,1591.0,4003.671,0.00031876564025878906,0.0003559589385986328,0.0,-2003.6709999999998
198,19:44:00,1,1000,100,7,8,15,5,12,1,1,14,4,1,1477.0,4783.323,0.000904083251953125,0.0008029937744140625,0.0,9216.677
198,19:44:00,1,1000,200,7,8,23,8,14,2,2,21,6,2,1586.6349394535791,5346.971,0.0016798973083496094,0.0014901161193847656,0.0,15653.029
198,19:44:00,1,1000,300,7,8,23,8,14,2,2,21,6,2,1586.6349394535791,5346.971,0.0017549991607666016,0.0015871524810791016,0.0,15653.029
198,19:44:00,1,1000,400,7,8,23,8,14,2,2,21,6,2,1586.6349394535791,5346.971,0.0017290115356445312,0.0013859272003173828,0.0,15653.029
198,19:44:00,1,1000,500,7,8,23,8,14,2,2,21,6,2,1586.6349394535791,5346.971,0.0017910003662109375,0.001580953598022461,0.0,15653.029
198,19:44:00,1,1000,600,7,8,23,8,14,2,2,21,6,2,1586.6349394535791,5346.971,0.0018038749694824219,0.0019578933715820312,0.0,15653.029
198,19:44:00,1,1000,700,7,8,23,8,14,2,2,21,6,2,1586.6349394535791,5346.971,0.0017249584197998047,0.0015060901641845703,0.0,15653.029
155,13:50:00,1,1000,0,14,15,7,3,18,0,0,7,3,0,2595.0,7077.207000000001,0.0010128021240234375,0.0005929470062255859,0.0,-77.20700000000124
155,13:50:00,1,1000,100,14,15,13,4,19,0,0,13,4,0,2595.0,7508.516000000001,0.0011339187622070312,0.0006999969482421875,0.0,5491.483999999999
155,13:50:00,1,1000,200,14,15,30,9,22,2,3,27,7,2,2614.4566034359377,8002.855000000001,0.0027871131896972656,0.002552032470703125,0.0,18997.144999999997
155,13:50:00,1,1000,300,14,15,31,9,22,2,3,28,7,2,2614.4566034359377,8002.855000000001,0.0034852027893066406,0.0027818679809570312,0.0,19997.144999999997
155,13:50:00,1,1000,400,14,15,32,10,22,3,4,28,7,3,2614.4566034359377,8002.855000000001,0.0029859542846679688,0.0030298233032226562,0.0,19997.144999999997
155,13:50:00,1,1000,500,14,15,32,10,22,3,4,28,7,3,2614.4566034359377,8002.855000000001,0.0030181407928466797,0.0026001930236816406,0.0,19997.144999999997
155,13:50:00,1,1000,600,14,15,32,10,22,3,4,28,7,3,2614.4566034359377,8002.855000000001,0.0029959678649902344,0.00267791748046875,0.0,19997.144999999997
155,13:50:00,1,1000,700,14,15,32,10,22,3,4,28,7,3,2614.4566034359377,8002.855000000001,0.0030231475830078125,0.0026569366455078125,0.0,19997.144999999997
187,13:47:00,0.2,1000,0,6,7,6,4,10,1,1,5,3,1,4552.0,11674.129,0.0005309581756591797,0.0005300045013427734,0.0,-6674.129000000001
187,13:47:00,0.2,1000,100,6,7,7,5,11,1,1,6,4,1,4552.0,11674.128999999999,0.0006241798400878906,0.000598907470703125,0.0,-5674.128999999999
187,13:47:00,0.2,1000,200,6,7,18,14,18,3,2,16,11,3,4552.0,13986.636999999997,0.003039121627807617,0.0027790069580078125,0.0,2013.363000000003
187,13:47:00,0.2,1000,300,6,7,27,21,24,4,3,24,17,4,5347.0,16227.112,0.007881879806518555,0.02898693084716797,0.0,7772.888000000001
187,13:47:00,0.2,1000,400,6,7,34,24,25,6,6,28,18,6,4756.045626043902,16227.112,0.00987696647644043,0.04188084602355957,0.0,11772.888
187,13:47:00,0.2,1000,500,6,7,38,27,28,6,8,30,21,6,4756.04562604391,17128.760000000002,0.012149810791015625,0.04794001579284668,0.0,12871.239999999998
187,13:47:00,0.2,1000,600,6,7,38,27,28,6,8,30,21,6,4756.04562604391,17128.760000000002,0.011772871017456055,0.047384023666381836,0.0,12871.239999999998
187,13:47:00,0.2,1000,700,6,7,38,27,28,6,8,30,21,6,4756.04562604391,17128.760000000002,0.012219905853271484,0.047882080078125,0.0,12871.239999999998
196,16:23:30,0,1000,0,1,2,6,4,3,3,4,2,1,3,782.8561948222341,2999.726,0.0004987716674804688,0.0006930828094482422,0.0,-999.7260000000001
196,16:23:30,0,1000,100,1,2,15,10,4,8,13,2,2,8,1179.0,3202.306,0.003432035446166992,0.022424936294555664,0.0,-1202.306
196,16:23:30,0,1000,200,1,2,21,15,3,14,19,2,1,14,1179.0,2999.726,0.0089111328125,0.07465291023254395,0.0,-999.7260000000001
196,16:23:30,0,1000,300,1,2,28,16,5,13,23,5,3,13,1149.591013481273,4404.97,0.012513875961303711,0.10164189338684082,0.0,595.0299999999997
196,16:23:30,0,1000,400,1,2,29,17,5,14,24,5,3,14,1149.591013481273,4404.97,0.014313936233520508,0.1182401180267334,0.0,595.0300000000002
196,16:23:30,0,1000,500,1,2,29,17,5,14,24,5,3,14,1149.591013481273,4404.97,0.014617681503295898,0.11624813079833984,0.0,595.0300000000002
196,16:23:30,0,1000,600,1,2,29,17,5,14,24,5,3,14,1149.591013481273,4404.97,0.014578819274902344,0.11484599113464355,0.0,595.0300000000002
196,16:23:30,0,1000,700,1,2,29,17,5,14,24,5,3,14,1149.591013481273,4404.97,0.014301776885986328,0.11255598068237305,0.0,595.0300000000002
194,07:10:00,0,1000,0,1,2,9,10,12,0,0,9,10,0,2475.871062992126,9486.972,0.0025200843811035156,0.0013399124145507812,0.0,-486.97199999999975
194,07:10:00,0,1000,100,1,2,34,18,20,0,0,34,18,0,2889.487592460031,11071.856,0.018709897994995117,0.0030739307403564453,0.0,22928.144
194,07:10:00,0,1000,200,1,2,48,24,26,0,0,48,24,0,3324.8021802672374,12739.882000000001,0.04385781288146973,0.025753021240234375,0.0,35260.118
194,07:10:00,0,1000,300,1,2,51,26,28,0,0,51,26,0,3324.802180267234,12739.882,0.05336904525756836,0.013962030410766602,0.0,38260.118
194,07:10:00,0,1000,400,1,2,51,26,28,0,0,51,26,0,3324.802180267234,12739.882,0.05377602577209473,0.014225006103515625,0.0,38260.118
194,07:10:00,0,1000,500,1,2,51,26,28,0,0,51,26,0,3324.802180267234,12739.882,0.054402828216552734,0.013964176177978516,0.0,38260.118
194,07:10:00,0,1000,600,1,2,51,26,28,0,0,51,26,0,3324.802180267234,12739.882,0.05412912368774414,0.014708995819091797,0.0,38260.118
194,07:10:00,0,1000,700,1,2,51,26,28,0,0,51,26,0,3324.802180267234,12739.882,0.054440975189208984,0.013853073120117188,0.0,38260.118
192,08:28:00,1,1000,0,12,13,7,2,15,0,0,7,2,0,3017.0,7954.378000000001,0.0006849765777587891,0.0005810260772705078,0.0,-954.3780000000006
192,08:28:00,1,1000,100,12,13,16,6,18,1,1,15,5,1,3039.98834556192,9285.518000000002,0.0014758110046386719,0.0006809234619140625,0.0,5714.481999999998
192,08:28:00,1,1000,200,12,13,26,9,21,1,1,25,8,1,3039.98834556192,10628.136999999997,0.002218961715698242,0.00072479248046875,0.0,14371.863000000003
192,08:28:00,1,1000,300,12,13,30,9,21,1,1,29,8,1,3039.98834556192,10628.136999999997,0.0024051666259765625,0.0007581710815429688,0.0,18371.863000000005
192,08:28:00,1,1000,400,12,13,33,10,21,2,2,31,8,2,3039.98834556192,10628.136999999997,0.021529197692871094,0.0008718967437744141,0.0,20371.863000000005
192,08:28:00,1,1000,500,12,13,33,10,21,2,2,31,8,2,3039.98834556192,10628.136999999997,0.0028700828552246094,0.0007171630859375,0.0,20371.863000000005
192,08:28:00,1,1000,600,12,13,33,10,21,2,2,31,8,2,3039.98834556192,10628.136999999997,0.0035409927368164062,0.0009059906005859375,0.0,20371.863000000005
192,08:28:00,1,1000,700,12,13,33,10,21,2,2,31,8,2,3039.98834556192,10628.136999999997,0.002972126007080078,0.0008509159088134766,0.0,20371.863000000005
155,13:50:00,0.2,1000,0,3,4,3,3,5,2,1,2,1,2,3179.0,5675.588000000001,0.0003261566162109375,0.0005462169647216797,0.0,-3675.5880000000006
155,13:50:00,0.2,1000,100,3,4,10,8,9,3,3,7,5,3,1766.5042352660457,6581.653000000001,0.0012841224670410156,0.0008938312530517578,0.0,418.34699999999884
155,13:50:00,0.2,1000,200,3,4,29,16,18,2,5,24,14,2,2273.0693599379592,8144.5560000000005,0.006409883499145508,0.0032410621643066406,0.0,15855.444
155,13:50:00,0.2,1000,300,3,4,32,18,18,4,7,25,14,4,2273.0693599379592,8144.5560000000005,0.00832366943359375,0.007142066955566406,0.0,16855.444
155,13:50:00,0.2,1000,400,3,4,32,18,18,4,7,25,14,4,2273.0693599379592,8144.5560000000005,0.009080886840820312,0.00705409049987793,0.0,16855.444
155,13:50:00,0.2,1000,500,3,4,32,18,18,4,7,25,14,4,2273.0693599379592,8144.5560000000005,0.008398056030273438,0.007113933563232422,0.0,16855.444
155,13:50:00,0.2,1000,600,3,4,32,18,18,4,7,25,14,4,2273.0693599379592,8144.5560000000005,0.008443117141723633,0.007066011428833008,0.0,16855.444
155,13:50:00,0.2,1000,700,3,4,32,18,18,4,7,25,14,4,2273.0693599379592,8144.5560000000005,0.008509159088134766,0.007173061370849609,0.0,16855.444
193,08:16:30,1,1000,0,13,14,12,2,15,1,2,10,1,1,2338.0,5818.773,0.0009131431579589844,0.00045180320739746094,0.0,4181.227
193,08:16:30,1,1000,100,13,14,23,4,17,1,2,21,3,1,2424.0270520162267,6718.671,0.0023260116577148438,0.0006899833679199219,0.0,14281.329
193,08:16:30,1,1000,200,13,14,41,8,20,2,5,36,6,2,2424.0270520162267,7796.377,0.003123044967651367,0.0008840560913085938,0.0,28203.623
193,08:16:30,1,1000,300,13,14,42,9,20,3,6,36,6,3,2424.0270520162267,7796.377,0.003364086151123047,0.0008609294891357422,0.0,28203.623
193,08:16:30,1,1000,400,13,14,43,9,20,3,6,37,6,3,2424.0270520162267,7796.377,0.0035860538482666016,0.0008981227874755859,0.0,29203.623
193,08:16:30,1,1000,500,13,14,43,9,20,3,6,37,6,3,2424.0270520162267,7796.377,0.0033941268920898438,0.0008819103240966797,0.0,29203.623
193,08:16:30,1,1000,600,13,14,43,9,20,3,6,37,6,3,2424.0270520162267,7796.377,0.0034532546997070312,0.0008530616760253906,0.0,29203.623
193,08:16:30,1,1000,700,13,14,43,9,20,3,6,37,6,3,2424.0270520162267,7796.377,0.0033669471740722656,0.0008218288421630859,0.0,29203.623
196,16:23:30,1,1000,0,14,15,8,1,15,1,2,6,0,1,3519.0,7461.312,0.0007748603820800781,0.00037980079650878906,0.0,-1461.312
196,16:23:30,1,1000,100,14,15,21,5,15,5,13,8,0,5,3519.0,7461.312,0.0018100738525390625,0.0010380744934082031,0.0,538.6880000000001
196,16:23:30,1,1000,200,14,15,23,7,17,5,14,9,2,5,3088.0,7484.494000000001,0.002335786819458008,0.0011210441589355469,0.0,1515.5059999999994
196,16:23:30,1,1000,300,14,15,28,7,17,5,17,11,2,5,3088.0,7484.494000000001,0.0031490325927734375,0.0011870861053466797,0.0,3515.5059999999994
196,16:23:30,1,1000,400,14,15,29,8,18,5,17,12,3,5,3088.0,7970.2880000000005,0.002783060073852539,0.001188039779663086,0.0,4029.7119999999995
196,16:23:30,1,1000,500,14,15,29,8,18,5,17,12,3,5,3088.0,7970.2880000000005,0.002904176712036133,0.0013651847839355469,0.0,4029.7119999999995
196,16:23:30,1,1000,600,14,15,29,8,18,5,17,12,3,5,3088.0,7970.2880000000005,0.002824068069458008,0.0013320446014404297,0.0,4029.7119999999995
196,16:23:30,1,1000,700,14,15,29,8,18,5,17,12,3,5,3088.0,7970.2880000000005,0.002763986587524414,0.0012078285217285156,0.0,4029.7119999999995
155,13:50:00,0,1000,0,1,2,3,4,6,0,0,3,4,0,1447.843667979003,5547.8060000000005,0.00036787986755371094,0.0005509853363037109,0.0,-2547.8060000000005
155,13:50:00,0,1000,100,1,2,12,11,13,0,0,12,11,0,1616.7605807086657,6195.057,0.0034961700439453125,0.0012369155883789062,0.0,5804.943
155,13:50:00,0,1000,200,1,2,28,18,20,0,0,28,18,0,2045.8326249701786,7839.163000000002,0.015856027603149414,0.0029408931732177734,0.0,20160.837
155,13:50:00,0,1000,300,1,2,32,20,22,0,0,32,20,0,2196.351258649491,8415.916000000001,0.022256851196289062,0.003181934356689453,0.0,23584.084
155,13:50:00,0,1000,400,1,2,32,20,22,0,0,32,20,0,2196.351258649491,8415.916000000001,0.021441936492919922,0.0031919479370117188,0.0,23584.084
155,13:50:00,0,1000,500,1,2,32,20,22,0,0,32,20,0,2196.351258649491,8415.916000000001,0.02131819725036621,0.0032401084899902344,0.0,23584.084
155,13:50:00,0,1000,600,1,2,32,20,22,0,0,32,20,0,2196.351258649491,8415.916000000001,0.022189855575561523,0.0031499862670898438,0.0,23584.084
155,13:50:00,0,1000,700,1,2,32,20,22,0,0,32,20,0,2196.351258649491,8415.916000000001,0.02121114730834961,0.0032198429107666016,0.0,23584.084
193,08:16:30,0,1000,0,1,2,9,3,5,0,0,9,3,0,1589.3474111190662,6090.0160000000005,0.0004851818084716797,0.0006020069122314453,0.0,2909.9839999999995
193,08:16:30,0,1000,100,1,2,13,6,8,0,0,13,6,0,1720.368274278222,6592.058000000001,0.0013270378112792969,0.0006799697875976562,0.0,6407.941999999999
193,08:16:30,0,1000,200,1,2,32,19,21,0,0,32,19,0,2522.7107566809827,9666.451000000001,0.037924766540527344,0.003072023391723633,0.0,22333.549
193,08:16:30,0,1000,300,1,2,41,21,23,0,0,41,21,0,2896.9233178239083,11100.348000000002,0.029155254364013672,0.0036640167236328125,0.0,29899.652
193,08:16:30,0,1000,400,1,2,43,21,23,0,0,43,21,0,2896.9233178239083,11100.348000000002,0.03033900260925293,0.0036840438842773438,0.0,31899.652
193,08:16:30,0,1000,500,1,2,43,21,23,0,0,43,21,0,2896.9233178239083,11100.348000000002,0.0313868522644043,0.0037000179290771484,0.0,31899.652
193,08:16:30,0,1000,600,1,2,43,21,23,0,0,43,21,0,2896.9233178239083,11100.348000000002,0.031017780303955078,0.003650188446044922,0.0,31899.652
193,08:16:30,0,1000,700,1,2,43,21,23,0,0,43,21,0,2896.9233178239083,11100.348000000002,0.030536890029907227,0.0036590099334716797,0.0,31899.652
192,08:28:00,0,1000,0,1,2,3,2,4,0,0,3,2,0,1191.1083646504449,4564.055,0.0002262592315673828,0.0007278919219970703,0.0,-1564.0550000000003
192,08:28:00,0,1000,100,1,2,16,14,14,2,2,14,12,2,2154.14428503051,8254.18852440034,0.00638890266418457,0.020693063735961914,0.0,5745.812473541246
192,08:28:00,0,1000,200,1,2,27,19,17,4,4,23,15,4,2291.0,8771.048999999997,0.017194032669067383,0.04583001136779785,0.0,14228.951000000003
192,08:28:00,0,1000,300,1,2,30,21,17,6,6,24,15,6,2204.8214806815377,8448.37195477607,0.02261209487915039,0.021619796752929688,0.0,15551.62804522398
192,08:28:00,0,1000,400,1,2,33,22,17,7,7,26,15,7,2291.0,8510.498000000001,0.026585817337036133,0.01631617546081543,0.0,17489.502
192,08:28:00,0,1000,500,1,2,33,22,17,7,7,26,15,7,2291.0,8510.498000000001,0.026582002639770508,0.016993045806884766,0.0,17489.502
192,08:28:00,0,1000,600,1,2,33,22,17,7,7,26,15,7,2291.0,8510.498000000001,0.02631688117980957,0.01627802848815918,0.0,17489.502
192,08:28:00,0,1000,700,1,2,33,22,17,7,7,26,15,7,2291.0,8510.498000000001,0.026308059692382812,0.01636505126953125,0.0,17489.502
194,07:10:00,1,1000,0,22,23,10,1,24,0,0,10,1,0,3787.0,9108.919,0.0014731884002685547,0.0007469654083251953,0.0,891.0810000000001
194,07:10:00,1,1000,100,22,23,28,6,26,3,4,24,3,3,3787.0,9582.364,0.003251791000366211,0.0016269683837890625,0.0,14417.636
194,07:10:00,1,1000,200,22,23,49,8,27,4,7,42,4,4,3787.0,9582.364,0.0053899288177490234,0.0017800331115722656,0.0,32417.636
194,07:10:00,1,1000,300,22,23,50,8,27,4,7,43,4,4,3787.0,9582.364,0.005725860595703125,0.0017580986022949219,0.0,33417.636
194,07:10:00,1,1000,400,22,23,51,9,28,4,7,44,5,4,3787.0,9769.698999999999,0.0065343379974365234,0.002073049545288086,0.0,34230.301
194,07:10:00,1,1000,500,22,23,51,9,28,4,7,44,5,4,3787.0,9769.698999999999,0.006134033203125,0.001909017562866211,0.0,34230.301
194,07:10:00,1,1000,600,22,23,51,9,28,4,7,44,5,4,3787.0,9769.698999999999,0.005943775177001953,0.0023109912872314453,0.0,34230.301
194,07:10:00,1,1000,700,22,23,51,9,28,4,7,44,5,4,3787.0,9769.698999999999,0.006062746047973633,0.0018570423126220703,0.0,34230.301
198,19:44:00,0,1000,0,1,2,1,2,4,0,0,1,2,0,955.4319896802626,3660.9970000000003,0.00018095970153808594,0.0004432201385498047,0.0,-2660.9970000000003
198,19:44:00,0,1000,100,1,2,13,10,12,0,0,13,10,0,1363.4111787162983,5224.28,0.003129243850708008,0.0025908946990966797,0.0,7775.72
198,19:44:00,0,1000,200,1,2,22,14,16,0,0,22,14,0,1643.0977466594923,6295.974999999999,0.008050918579101562,0.010699033737182617,0.0,15704.025000000001
198,19:44:00,0,1000,300,1,2,23,14,16,0,0,23,14,0,1643.0977466595068,6295.974999999999,0.00851297378540039,0.014242172241210938,0.0,16704.025
198,19:44:00,0,1000,400,1,2,23,14,16,0,0,23,14,0,1643.0977466595068,6295.974999999999,0.00841665267944336,0.014261960983276367,0.0,16704.025
198,19:44:00,0,1000,500,1,2,23,14,16,0,0,23,14,0,1643.0977466595068,6295.974999999999,0.008871793746948242,0.01446080207824707,0.0,16704.025
198,19:44:00,0,1000,600,1,2,23,14,16,0,0,23,14,0,1643.0977466595068,6295.974999999999,0.008380889892578125,0.01471710205078125,0.0,16704.025
198,19:44:00,0,1000,700,1,2,23,14,16,0,0,23,14,0,1643.0977466595068,6295.974999999999,0.008532047271728516,0.014030933380126953,0.0,16704.025
185,15:27:00,0.4,1000,0,7,8,6,3,9,2,1,5,1,2,3837.0,7709.9529999999995,0.0005159378051757812,0.0004901885986328125,0.0,-2709.9529999999995
185,15:27:00,0.4,1000,100,7,8,11,7,13,2,1,10,5,2,2998.0,9239.96,0.0009648799896240234,0.0009350776672363281,0.0,760.0400000000009
185,15:27:00,0.4,1000,200,7,8,24,16,22,2,2,22,14,2,3139.08592817944,10856.823000000002,0.0045528411865234375,0.001413106918334961,0.0,11143.176999999998
185,15:27:00,0.4,1000,300,7,8,26,18,23,3,3,23,15,3,3308.31836077309,11505.283000000003,0.005922079086303711,0.0014481544494628906,0.0,11494.716999999997
185,15:27:00,0.4,1000,400,7,8,26,18,23,3,3,23,15,3,3308.31836077309,11505.283000000003,0.005220174789428711,0.0015468597412109375,0.0,11494.716999999997
185,15:27:00,0.4,1000,500,7,8,26,18,23,3,3,23,15,3,3308.31836077309,11505.283000000003,0.0052642822265625,0.0014889240264892578,0.0,11494.716999999997
185,15:27:00,0.4,1000,600,7,8,26,18,23,3,3,23,15,3,3308.31836077309,11505.283000000003,0.005262851715087891,0.0014920234680175781,0.0,11494.716999999997
185,15:27:00,0.4,1000,700,7,8,26,18,23,3,3,23,15,3,3308.31836077309,11505.283000000003,0.005298137664794922,0.0014519691467285156,0.0,11494.716999999997
192,08:28:00,0.2,1000,0,2,3,3,2,4,1,1,2,1,1,3342.0,5874.095000000001,0.0002338886260986328,0.00045800209045410156,0.0,-3874.095000000001
192,08:28:00,0.2,1000,100,2,3,16,13,13,3,3,13,10,3,3342.0,10095.065,0.0035800933837890625,0.03220510482788086,0.0,2904.9349999999995
192,08:28:00,0.2,1000,200,2,3,27,18,16,5,6,21,13,5,2837.2154020520175,10865.283,0.00878000259399414,0.11799907684326172,0.0,10134.717
192,08:28:00,0.2,1000,300,2,3,30,20,15,8,9,21,12,8,2837.2154020520175,10865.283,0.011791229248046875,0.11655712127685547,0.0,10134.716999999999
192,08:28:00,0.2,1000,400,2,3,33,21,15,9,11,22,12,9,3342.0,10865.759999999998,0.014256715774536133,0.07715201377868652,0.0,11134.240000000002
192,08:28:00,0.2,1000,500,2,3,33,21,15,9,11,22,12,9,3342.0,10865.759999999998,0.014379024505615234,0.07630300521850586,0.0,11134.240000000002
192,08:28:00,0.2,1000,600,2,3,33,21,15,9,11,22,12,9,3342.0,10865.759999999998,0.014271020889282227,0.07529497146606445,0.0,11134.240000000002
192,08:28:00,0.2,1000,700,2,3,33,21,15,9,11,22,12,9,3342.0,10865.759999999998,0.014568805694580078,0.0766139030456543,0.0,11134.240000000002
187,13:47:00,0.4,1000,0,12,13,6,3,16,0,0,6,3,0,5502.0,11674.129,0.0008029937744140625,0.000514984130859375,0.0,-5674.129000000001
187,13:47:00,0.4,1000,100,12,13,11,4,17,0,0,11,4,0,4845.0,11674.128999999999,0.000985860824584961,0.0007119178771972656,0.0,-674.128999999999
187,13:47:00,0.4,1000,200,12,13,18,10,19,4,3,15,6,4,4845.0,12419.044,0.002468109130859375,0.001958131790161133,0.0,2580.956
187,13:47:00,0.4,1000,300,12,13,27,17,25,5,3,24,12,5,4845.0,13980.162999999997,0.0041959285736083984,0.007971048355102539,0.0,10019.837
187,13:47:00,0.4,1000,400,12,13,35,19,27,5,5,30,14,5,5502.0,15428.124000000002,0.006043195724487305,0.029684066772460938,0.0,14571.875999999998
187,13:47:00,0.4,1000,500,12,13,38,21,28,6,6,32,15,6,4845.0,15428.124000000002,0.007590055465698242,0.03307795524597168,0.0,16571.875999999997
187,13:47:00,0.4,1000,600,12,13,38,21,28,6,6,32,15,6,4845.0,15428.124000000002,0.007452964782714844,0.03169393539428711,0.0,16571.875999999997
187,13:47:00,0.4,1000,700,12,13,38,21,28,6,6,32,15,6,4845.0,15428.124000000002,0.008074045181274414,0.036170005798339844,0.0,16571.875999999997
55,18:56:00,0,1000,0,1,2,3,5,5,2,2,1,3,2,3070.5357089596655,11765.591,0.0004887580871582031,0.0007159709930419922,0.0,-10765.591
55,18:56:00,0,1000,100,1,2,4,6,6,2,2,2,4,2,3084.6980881651107,11819.858,0.0007050037384033203,0.0008418560028076172,0.0,-9819.858
55,18:56:00,0,1000,200,1,2,18,17,17,2,2,16,15,2,3724.8970263660303,14272.954000000003,0.01072382926940918,0.002373933792114258,0.0,1727.0459999999966
55,18:56:00,0,1000,300,1,2,51,31,32,1,1,50,30,1,4859.461569434512,18620.346000000005,0.07514786720275879,0.00744318962097168,0.0,31379.653999999995
55,18:56:00,0,1000,400,1,2,54,33,34,1,1,53,32,1,4912.640106776438,18824.114000000005,0.08900213241577148,0.008929967880249023,0.0,34175.886
55,18:56:00,0,1000,500,1,2,58,35,36,1,1,57,34,1,5276.022168038675,20216.511000000002,0.10965871810913086,0.009485960006713867,0.0,36783.489
55,18:56:00,0,1000,600,1,2,58,35,36,1,1,57,34,1,5276.022168038675,20216.511000000002,0.1079411506652832,0.009692907333374023,0.0,36783.489
55,18:56:00,0,1000,700,1,2,58,35,36,1,1,57,34,1,5276.022168038675,20216.511000000002,0.10723686218261719,0.009425878524780273,0.0,36783.489
155,13:50:00,0.4,1000,0,6,7,3,3,10,0,0,3,3,0,2025.0,6358.882,0.00040912628173828125,0.0005750656127929688,0.0,-3358.8819999999996
155,13:50:00,0.4,1000,100,6,7,10,7,14,0,0,10,7,0,2025.0,7219.932000000001,0.0011227130889892578,0.0011591911315917969,0.0,2780.0679999999993
155,13:50:00,0.4,1000,200,6,7,31,15,20,2,2,29,13,2,2451.2751282510144,9094.413,0.0043599605560302734,0.0052411556243896484,0.0,19905.587
155,13:50:00,0.4,1000,300,6,7,32,16,22,1,2,30,15,1,2470.2817048437573,9443.704000000203,0.005085945129394531,0.006575107574462891,0.0,20556.296000000242
155,13:50:00,0.4,1000,400,6,7,32,16,22,1,2,30,15,1,2470.2817048437573,9443.704000000203,0.00498509407043457,0.006537914276123047,0.0,20556.296000000242
155,13:50:00,0.4,1000,500,6,7,32,16,22,1,2,30,15,1,2470.2817048437573,9443.704000000203,0.005002021789550781,0.006217002868652344,0.0,20556.296000000242
155,13:50:00,0.4,1000,600,6,7,32,16,22,1,2,30,15,1,2470.2817048437573,9443.704000000203,0.004910945892333984,0.006229877471923828,0.0,20556.296000000242
155,13:50:00,0.4,1000,700,6,7,32,16,22,1,2,30,15,1,2470.2817048437573,9443.704000000203,0.005558967590332031,0.006036043167114258,0.0,20556.296000000242
193,08:16:30,0.2,1000,0,2,3,11,3,5,1,1,10,2,1,1532.8764018134098,5873.6320000000005,0.0004930496215820312,0.0005791187286376953,0.0,4126.3679999999995
193,08:16:30,0.2,1000,100,2,3,15,6,7,2,3,12,4,2,1663.897264972562,6375.674000000001,0.0010800361633300781,0.0006918907165527344,0.0,5624.325999999999
193,08:16:30,0.2,1000,200,2,3,34,19,13,9,14,20,10,9,2209.3826279527566,7591.200000000001,0.011565208435058594,0.004807949066162109,0.0,12408.8
193,08:16:30,0.2,1000,300,2,3,42,20,13,10,20,22,10,10,2209.3826279527566,7591.200000000001,0.015460014343261719,0.007330894470214844,0.0,14408.8
193,08:16:30,0.2,1000,400,2,3,43,20,13,10,20,23,10,10,2209.3826279527566,7591.200000000001,0.015666961669921875,0.006256103515625,0.0,15408.8
193,08:16:30,0.2,1000,500,2,3,43,20,13,10,20,23,10,10,2209.3826279527566,7591.200000000001,0.016064167022705078,0.006139993667602539,0.0,15408.8
193,08:16:30,0.2,1000,600,2,3,43,20,13,10,20,23,10,10,2209.3826279527566,7591.200000000001,0.015352010726928711,0.005867958068847656,0.0,15408.8
193,08:16:30,0.2,1000,700,2,3,43,20,13,10,20,23,10,10,2209.3826279527566,7591.200000000001,0.015290975570678711,0.006175994873046875,0.0,15408.8
187,16:47:00,0,1000,0,1,2,2,2,4,0,0,2,2,0,1404.1388168098274,5380.338999999999,0.00020503997802734375,0.0005788803100585938,0.0,-3380.338999999999
187,16:47:00,0,1000,100,1,2,9,9,8,3,2,7,6,3,1568.2394192913416,6009.134999999999,0.001873016357421875,0.001104116439819336,0.0,990.8650000000007
187,16:47:00,0,1000,200,1,2,22,22,21,3,3,19,19,3,3254.2212479121954,12469.431999999999,0.018230915069580078,0.07178592681884766,0.0,6530.568000000001
187,16:47:00,0,1000,300,1,2,33,26,25,3,3,30,23,3,3365.845338224768,12897.149999999996,0.03559589385986328,0.006695985794067383,0.0,17102.850000000006
187,16:47:00,0,1000,400,1,2,40,29,25,6,6,34,23,6,3291.052332779531,12610.560298677936,0.05204296112060547,0.0326840877532959,0.0,21389.440411521544
187,16:47:00,0,1000,500,1,2,43,32,27,7,7,36,25,7,3369.0,12610.559999999992,0.06738996505737305,0.07314705848693848,0.0,23389.44000000001
187,16:47:00,0,1000,600,1,2,43,32,27,7,7,36,25,7,3369.0,12610.559999999992,0.0669257640838623,0.07367992401123047,0.0,23389.44000000001
187,16:47:00,0,1000,700,1,2,43,32,27,7,7,36,25,7,3369.0,12610.559999999992,0.06694388389587402,0.07218194007873535,0.0,23389.44000000001
