route,route_starting_time,percentage_of_compulsory_stops,benefit,walking_distance,num_segments,compulsory_stops,requests,number_optional_stops,used_nodes,unused_nodes,unserved_requests,served_requests,opt_stops_visited,opt_stops_not_visited,total_used-travel_time,travel_distance,build_time,solve_time,optimality_gap,obj_val
55,18:56:00,0.4,1100,300,11,12,58,42,35,19,19,39,23,19,5139.0,22378.581,0.05360698699951172,2.003355026245117,0.0,20521.419
195,07:09:00,0.4,1100,300,9,10,48,31,22,19,31,17,12,19,2447.0,10167.859999999999,0.021870136260986328,0.010432958602905273,0.0,8532.140000000001
196,16:23:30,0.4,1100,300,6,7,29,20,15,12,12,17,8,12,2060.0,8070.053999999999,0.008973121643066406,0.018173933029174805,0.0,10629.946
199,16:04:00,0,1100,300,1,2,43,33,24,11,16,27,22,11,3069.0,13561.567,0.0657799243927002,0.17051100730895996,0.0,16138.433
192,14:50:30,0.2,1100,300,3,4,53,38,22,20,28,25,18,20,2118.0,9095.5,0.054576873779296875,0.12631511688232422,0.0,18404.5
195,07:09:00,1,1100,300,22,23,48,24,26,21,34,14,3,21,2459.528901216894,9635.070999999998,0.01097869873046875,0.002012968063354492,0.0,5764.929000000002
196,09:57:30,0.4,1100,300,6,7,15,15,18,4,6,9,11,4,1956.0,8197.720000000001,0.0029981136322021484,0.0014328956604003906,0.0,1702.2799999999988
155,07:44:30,0.2,1100,300,2,3,45,33,19,17,20,25,16,17,1926.0,8477.269,0.06759095191955566,0.03702497482299805,0.0,19022.731
55,15:58:00,0.4,1100,300,9,10,71,50,26,34,48,23,16,34,4126.0,13052.034,0.06318211555480957,0.028345108032226562,0.0,12247.966
196,16:23:30,0.2,1100,300,3,4,29,22,15,11,11,18,11,11,1954.0,8481.37,0.011523723602294922,0.09280991554260254,0.0,11318.63
195,07:09:00,0,1100,300,1,2,48,38,27,13,15,33,25,13,2514.0,10919.939,0.10577607154846191,0.24068880081176758,0.0,25380.061
199,16:04:00,1,1100,300,19,20,43,18,24,14,25,18,4,14,3025.0,12523.838999999996,0.0074350833892822266,0.004793882369995117,0.0,7276.161000000004
55,18:56:00,0.2,1100,300,5,6,58,48,44,10,11,47,38,10,5139.0,22730.953000000005,0.11852097511291504,0.5902769565582275,0.0,28969.046999999995
195,07:09:00,0.2,1100,300,4,5,48,35,24,16,22,26,19,16,2514.0,10751.148000000001,0.04069399833679199,0.15763306617736816,0.0,17848.851999999963
196,09:57:30,0.2,1100,300,3,4,15,16,17,3,4,11,13,3,2020.0,8184.095000000002,0.004409074783325195,0.007781982421875,0.0,3915.9049999999993
155,07:44:30,0.4,1100,300,5,6,45,30,17,19,25,20,11,19,1926.0,8149.008000000002,0.03483223915100098,0.018681049346923828,0.0,13850.991999999998
55,15:58:00,0.2,1100,300,4,5,71,53,34,24,32,39,29,24,4126.0,15916.99199999992,0.08436298370361328,0.07197690010070801,8.089488333750785e-15,26983.007999999834
192,14:50:30,0.4,1100,300,6,7,53,36,24,19,29,24,17,19,2090.0,9008.505000000041,0.024459123611450195,0.023495197296142578,0.0,17391.495000000134
194,15:17:30,1,1100,300,22,23,48,17,25,15,25,23,2,15,2343.0,9042.614999999998,0.008229970932006836,0.001207113265991211,0.0,16257.385000000002
185,15:27:00,1,1100,300,17,18,26,18,23,13,20,6,5,13,2113.0,8614.527999999998,0.005337953567504883,0.0009770393371582031,0.0,-2014.5279999999984
198,10:24:30,0,1100,300,1,2,17,17,9,10,10,7,7,10,790.0,3510.5789999999997,0.009298086166381836,0.006166934967041016,0.0,4189.421
191,07:22:00,0,1100,300,1,2,31,24,14,12,16,15,12,12,1387.0,6152.289734896091,0.02887415885925293,0.017635107040405273,0.0,10347.71026510391
195,13:21:00,0,1100,300,1,2,40,42,27,17,17,23,25,17,2556.0,11374.161000000002,0.10973000526428223,0.4333469867706299,0.0,13925.838999999998
194,15:17:30,0.2,1100,300,4,5,48,28,22,11,22,26,17,11,2356.8992931281246,10297.189999999999,0.02748870849609375,0.004612922668457031,0.0,18302.81
198,19:44:00,0.4,1100,300,3,4,23,13,11,6,8,15,7,6,929.594890837514,3879.101,0.003964900970458984,0.004201173782348633,0.0,12620.899
191,13:41:30,0,1100,300,1,2,23,18,11,9,12,11,9,9,1422.0,6109.509684128705,0.013467073440551758,0.009750843048095703,0.0,5990.490315871295
198,10:24:30,0.4,1100,300,3,4,17,15,9,10,14,3,5,10,747.0,3225.6719999999996,0.004050016403198242,0.0014410018920898438,0.0,74.32800000000043
155,07:44:30,1,1100,300,12,13,45,24,15,22,32,13,2,22,1868.0,7659.410000000001,0.008753061294555664,0.0012729167938232422,0.0,6640.589999999999
155,07:44:30,0,1100,300,1,2,45,34,21,15,16,29,19,15,1926.0,8514.778,0.08309674263000488,0.029855966567993164,0.0,23385.222
191,13:41:30,1,1100,300,14,15,23,11,15,11,18,5,0,11,1422.0,5202.024684128705,0.0027959346771240234,0.000518798828125,0.0,297.9753158712947
198,10:24:30,0.2,1100,300,2,3,17,16,8,11,14,3,5,11,747.0,3225.672000000005,0.005454063415527344,0.004287004470825195,0.0,74.3280000000068
198,10:24:30,1,1100,300,7,8,17,12,9,11,15,2,1,11,790.0,2855.7120000000004,0.0019450187683105469,0.0006139278411865234,0.0,-655.7120000000004
195,13:21:00,1,1100,300,22,23,40,27,26,24,30,10,3,24,2468.0,9746.443,0.009488105773925781,0.002017974853515625,0.0,1253.5570000000007
191,07:22:00,1,1100,300,13,14,31,14,16,12,22,9,2,12,1387.0,5095.854734896091,0.003954887390136719,0.0006401538848876953,0.0,4804.145265103909
194,15:17:30,0,1100,300,1,2,48,31,24,9,14,34,22,9,2381.9999999999927,10639.332000000002,0.07143378257751465,0.043092966079711914,1.9704106457378917e-09,26760.667999999998
198,19:44:00,0.2,1100,300,1,2,23,15,11,6,7,16,9,6,946.0,3955.6100000000006,0.009647846221923828,0.007447957992553711,0.0,13644.39
194,15:17:30,0.4,1100,300,9,10,48,25,22,13,24,24,12,13,2343.0,9398.907,0.011332988739013672,0.003381013870239258,0.0,17001.093
185,15:27:00,0,1100,300,1,2,26,29,19,12,11,15,17,12,2159.0,9285.613429912053,0.03584122657775879,0.03752779960632324,0.0,7214.387670088086
195,13:21:00,0.2,1100,300,4,5,40,40,25,20,21,19,20,20,2468.0,10616.565999999999,0.04367685317993164,0.2599492073059082,0.0,10283.434
194,07:10:00,0.2,1100,300,4,5,51,33,24,14,15,36,19,14,2372.0,10220.586,0.0344691276550293,0.07294797897338867,0.0,29379.414
55,15:58:00,0,1100,300,1,2,71,56,45,13,15,56,43,13,4074.0,18159.20628868304,0.32236409187316895,0.20223283767700195,0.0,43440.79438457891
199,13:24:30,0,1100,300,1,2,30,32,24,10,10,20,22,10,3030.0,13362.374,0.048501014709472656,0.10105299949645996,0.0,8637.626
196,09:57:30,1,1100,300,14,15,15,10,18,7,10,5,3,7,1956.0,7688.5470000000005,0.002396821975708008,0.0008330345153808594,0.0,-2188.5470000000005
185,07:21:00,1,1100,300,28,29,89,35,33,31,51,38,4,31,3435.0,13574.43,0.02214193344116211,0.0017960071563720703,0.0,28225.57
191,07:22:00,0.2,1100,300,2,3,31,24,15,12,19,12,12,12,1387.0,5757.66873489609,0.017069101333618164,0.053956031799316406,0.0,7442.33126510391
199,16:04:00,0.4,1100,300,8,9,43,27,23,13,20,23,14,13,3025.0,12543.371,0.021448850631713867,0.04264402389526367,0.0,12756.629
193,13:30:30,1,1100,300,14,15,48,22,16,21,34,14,1,21,1565.0,6125.9890000000005,0.010724306106567383,0.0012860298156738281,0.0,9274.010999999999
193,13:30:30,0.2,1100,300,3,4,48,30,16,18,29,19,12,18,1580.9895758768762,7001.405000000001,0.05363917350769043,0.030848979949951172,0.0,13898.595
199,13:24:30,0.2,1100,300,4,5,30,29,20,14,17,13,15,14,3030.0,12630.503999999999,0.012574911117553711,0.008279085159301758,0.0,1669.496000000001
192,14:50:30,1,1100,300,14,15,53,30,22,23,38,15,7,23,2090.0,8393.471,0.013713359832763672,0.002407073974609375,0.0,8106.529
187,16:47:00,0.4,1100,300,12,13,43,44,34,23,21,22,21,23,3338.0,14354.793,0.03505682945251465,0.013458013534545898,0.0,9845.207
187,13:47:00,1,1100,300,29,30,38,26,35,21,21,17,5,21,3294.0,12707.103000000003,0.010073661804199219,0.001177072525024414,0.0,5992.896999999997
185,07:21:00,0.2,1100,300,5,6,89,54,40,20,28,61,34,20,3524.1275501073724,15555.145,0.11390399932861328,0.24327492713928223,0.0,51544.854999999996
191,13:41:30,0.4,1100,300,6,7,23,14,11,10,15,8,4,10,1381.0,5766.575684128705,0.004974842071533203,0.0021309852600097656,0.0,3033.424315871295
187,13:47:00,0,1100,300,1,2,38,43,34,11,9,29,32,11,3294.0,14461.387999999999,0.10454297065734863,0.12000393867492676,0.0,17438.612
191,07:22:00,0.4,1100,300,5,6,31,21,14,13,21,10,8,13,1358.0,5423.882734896091,0.0076100826263427734,0.0040340423583984375,0.0,5576.117265103909
199,16:04:00,0.2,1100,300,4,5,43,30,21,14,17,26,16,14,3069.0,13207.301,0.03680896759033203,0.029208898544311523,0.0,15392.699
195,13:21:00,0.4,1100,300,9,10,40,36,24,22,25,15,14,22,2468.0,9517.533,0.022185087203979492,0.02123093605041504,0.0,6982.467000000001
194,07:10:00,0.4,1100,300,9,10,51,29,25,14,18,33,15,14,2372.0,9920.453999999998,0.029758930206298828,0.07168412208557129,0.0,26379.546000000002
192,14:50:30,0,1100,300,1,2,53,40,21,21,24,29,19,21,2118.0,9385.818,0.12682390213012695,0.3060319423675537,0.0,22514.182
185,07:21:00,0,1100,300,1,2,89,58,40,20,25,64,38,20,3527.0,15636.57028049104,0.4260439872741699,0.19086599349975586,0.0,54763.43068678009
196,09:57:30,0,1100,300,1,2,15,18,17,3,2,13,15,3,1990.4809413027906,8898.246,0.009491205215454102,0.09718608856201172,0.0,5401.754000000001
193,13:30:30,0,1100,300,1,2,48,32,16,18,23,25,14,18,1589.0,7079.412000000001,0.0750269889831543,0.0880579948425293,0.0,20420.588
185,07:21:00,0.4,1100,300,11,12,89,48,38,22,34,55,26,22,3527.0,15337.58300000001,0.07097005844116211,0.1019599437713623,0.0,45162.417
191,13:41:30,0.2,1100,300,3,4,23,17,12,9,12,11,8,9,1422.0,6109.509684128758,0.008137941360473633,0.004374980926513672,0.0,5990.490315871393
193,13:30:30,0.4,1100,300,6,7,48,28,17,18,30,18,10,18,1569.2321045096614,6737.3240000000005,0.022232770919799805,0.008581876754760742,0.0,13062.676
199,13:24:30,0.4,1100,300,8,9,30,26,21,14,17,13,12,14,3030.0,12630.503999999999,0.01028895378112793,0.005944967269897461,0.0,1669.496000000001
199,13:24:30,1,1100,300,19,20,30,20,24,16,19,11,4,16,2990.0,12192.131999999998,0.005563974380493164,0.0014460086822509766,0.0,-92.13199999999779
187,16:47:00,0.2,1100,300,6,7,43,47,37,17,17,26,30,17,3338.0,14712.669,0.0612642765045166,0.020487070083618164,0.0,13887.331
55,15:58:00,1,1100,300,22,23,71,40,27,36,55,16,4,36,4074.0,15644.422000000002,0.028795957565307617,0.002183198928833008,0.0,1955.5779999999977
187,16:47:00,1,1100,300,29,30,43,34,37,27,27,16,7,27,3294.0,13123.513999999997,0.012880802154541016,0.0016770362854003906,0.0,4476.486000000003
185,15:27:00,0.2,1100,300,3,4,26,27,17,14,13,13,13,14,2159.0,9252.3,0.016740083694458008,0.02213907241821289,0.0,5047.700000000001
192,08:28:00,0.4,1100,300,5,6,33,25,17,14,15,18,11,14,1976.0695687186817,8368.284,0.010350227355957031,0.017650127410888672,0.0,11431.716
55,18:56:00,1,1100,300,27,28,58,34,33,29,37,21,5,29,5139.0,19680.796000000002,0.016392946243286133,0.0023581981658935547,0.0,3419.203999999998
193,08:16:30,0.4,1100,300,5,6,43,25,16,15,22,21,10,15,1472.0,6100.402,0.016120195388793945,0.0040781497955322266,0.0,16999.598
198,19:44:00,1,1100,300,7,8,23,9,10,7,11,12,2,7,946.0,3464.248,0.0020999908447265625,0.0010421276092529297,0.0,9735.752
155,13:50:00,1,1100,300,14,15,32,21,17,19,24,8,2,19,1607.0,6196.468000000001,0.005713224411010742,0.0010530948638916016,0.0,2603.5319999999992
187,13:47:00,0.2,1100,300,6,7,38,40,34,13,12,26,27,13,3338.0,14308.289999999999,0.030298233032226562,0.012339115142822266,0.0,14291.71
196,16:23:30,0,1100,300,1,2,29,23,19,6,5,24,17,6,2060.0,8826.838999999998,0.025964021682739258,1.2203359603881836,0.0,17573.161
194,07:10:00,0,1100,300,1,2,51,36,25,13,14,37,23,13,2372.0,10407.921,0.09997701644897461,0.16072416305541992,0.0,30292.078999999998
192,08:28:00,1,1100,300,12,13,33,18,16,15,16,17,3,15,1966.275724767358,7896.714000000001,0.004976987838745117,0.0010869503021240234,0.0,10803.286
155,13:50:00,0.2,1100,300,3,4,32,26,16,14,17,15,12,14,1646.0,6856.992,0.019562959671020508,0.022053956985473633,0.0,9643.008
193,08:16:30,1,1100,300,13,14,43,18,14,18,32,11,0,18,1444.0,5418.034000000001,0.006376981735229492,0.0008440017700195312,0.0,6681.965999999999
196,16:23:30,1,1100,300,14,15,29,14,17,12,21,8,2,12,1954.0,7484.485000000001,0.004832029342651367,0.0011181831359863281,0.0,1315.5149999999994
155,13:50:00,0,1100,300,1,2,32,28,17,13,14,18,15,13,1646.0,7354.912999999999,0.040335893630981445,0.03838396072387695,0.0,12445.087000000001
193,08:16:30,0,1100,300,1,2,43,29,17,14,21,22,15,14,1472.0,6423.114,0.05748724937438965,0.03976917266845703,0.0,17776.886
192,08:28:00,0,1100,300,1,2,33,29,20,11,12,21,18,11,1991.0,8808.143,0.04482269287109375,0.13334989547729492,0.0,14291.857
194,07:10:00,1,1100,300,22,23,51,19,26,16,28,23,3,16,2334.0,8928.65,0.008812665939331055,0.001032114028930664,0.0,16371.35
198,19:44:00,0,1100,300,1,2,23,15,11,6,7,16,9,6,946.0,3955.6100000000006,0.010591983795166016,0.007773160934448242,0.0,13644.39
185,15:27:00,0.4,1100,300,7,8,26,25,18,15,17,9,10,15,2127.43450250537,8830.391999999996,0.008731842041015625,0.0033500194549560547,0.0,1069.6080000000038
192,08:28:00,0.2,1100,300,2,3,33,28,19,12,12,21,16,12,1991.0,8808.142999999935,0.02628016471862793,0.06249690055847168,0.0,14291.85700000002
187,13:47:00,0.4,1100,300,12,13,38,35,32,16,16,22,19,16,3338.0,13591.056,0.01979231834411621,0.015360832214355469,0.0,10608.944
55,18:56:00,0,1100,300,1,2,58,52,43,11,11,47,41,11,5139.0,22551.705451478436,0.23110008239746094,0.571465015411377,0.0,29148.29535964273
155,13:50:00,0.4,1100,300,6,7,32,24,16,15,20,12,9,15,1607.0,6894.880999999999,0.010373830795288086,0.017423152923583984,0.0,6305.119000000001
193,08:16:30,0.2,1100,300,2,3,43,28,17,14,21,22,14,14,1472.0,6494.521999999999,0.03586697578430176,0.01542210578918457,0.0,17705.478000000003
187,16:47:00,0,1100,300,1,2,43,52,37,17,17,26,35,17,3338.0,14712.669,0.19524478912353516,1.3603100776672363,0.0,13887.331
