route,route_starting_time,percentage_of_compulsory_stops,benefit,walking_distance,num_segments,compulsory_stops,requests,number_optional_stops,used_nodes,unused_nodes,unserved_requests,served_requests,opt_stops_visited,opt_stops_not_visited,total_used-travel_time,travel_distance,build_time,solve_time,optimality_gap,obj_val
55,18:56:00,0.4,1000,700,11,12,58,42,35,19,19,39,23,19,5139.0,22378.581,0.047965288162231445,1.0812630653381348,0.0,16621.419
195,07:09:00,0.4,1000,700,9,10,48,31,22,19,31,17,12,19,2447.0,10167.859999999999,0.02176690101623535,0.009638071060180664,0.0,6832.140000000001
196,16:23:30,0.4,1000,700,6,7,29,20,16,11,12,17,9,11,1954.0,8070.053999999999,0.008947134017944336,0.02072000503540039,0.0,8929.946
199,16:04:00,0,1000,700,1,2,43,33,25,10,14,29,23,10,3069.0,13697.976999999999,0.07305383682250977,0.19582200050354004,0.0,15302.023510617044
192,14:50:30,0.2,1000,700,3,4,53,38,22,20,28,25,18,20,2118.0,9095.5,0.05337405204772949,0.14093303680419922,0.0,15904.5
195,07:09:00,1,1000,700,22,23,48,24,26,21,34,14,3,21,2459.528901216894,9635.070999999998,0.01098012924194336,0.002012968063354492,0.0,4364.929000000002
196,09:57:30,0.4,1000,700,6,7,15,15,18,4,6,9,11,4,1956.0,8197.720000000001,0.002904176712036133,0.0012860298156738281,0.0,802.2799999999988
155,07:44:30,0.2,1000,700,2,3,45,33,19,17,20,25,16,17,1926.0,8477.269,0.0689401626586914,0.03317999839782715,0.0,16522.731
55,15:58:00,0.4,1000,700,9,10,71,50,28,32,48,23,18,32,4126.0,13052.034825117442,0.062384843826293945,0.034689903259277344,0.0,9947.96611268328
196,16:23:30,0.2,1000,700,3,4,29,22,17,9,11,18,13,9,1954.0,8481.369999999999,0.011199951171875,0.0852959156036377,0.0,9518.630000000001
195,07:09:00,0,1000,700,1,2,48,38,27,13,15,33,25,13,2514.0,10919.939,0.10640621185302734,0.28233909606933594,0.0,22080.061
199,16:04:00,1,1000,700,19,20,43,18,24,14,24,19,4,14,3025.0,12511.964999999998,0.00817418098449707,0.0024700164794921875,0.0,6488.035000000002
55,18:56:00,0.2,1000,700,5,6,58,48,44,10,11,47,38,10,5139.0,22730.953000000005,0.1238548755645752,0.6226449012756348,0.0,24269.046999999995
195,07:09:00,0.2,1000,700,4,5,48,35,25,15,22,26,20,15,2514.0,10751.147999999986,0.04590415954589844,0.2149968147277832,0.0,15248.851999999975
196,09:57:30,0.2,1000,700,3,4,15,16,17,3,4,11,13,3,2020.0,8184.095,0.003862142562866211,0.00881195068359375,0.0,2815.9049999999997
155,07:44:30,0.4,1000,700,5,6,45,30,17,19,25,20,11,19,1926.0,8149.008000000002,0.03523826599121094,0.01927495002746582,0.0,11850.991999999998
55,15:58:00,0.2,1000,700,4,5,71,53,34,24,32,39,29,24,4126.0,15916.992,0.08589696884155273,0.06450986862182617,0.0,23083.008
192,14:50:30,0.4,1000,700,6,7,53,36,24,19,29,24,17,19,2118.0,9008.505000000001,0.02532505989074707,0.012779951095581055,0.0,14991.494999999999
194,15:17:30,1,1000,700,22,23,48,17,25,15,25,23,2,15,2343.0,9042.614999999998,0.008002042770385742,0.001107931137084961,0.0,13957.385000000002
185,15:27:00,1,1000,700,17,18,26,18,23,13,20,6,5,13,2113.0,8614.527999999998,0.004698991775512695,0.0007429122924804688,0.0,-2614.5279999999984
198,10:24:30,0,1000,700,1,2,17,17,9,10,10,7,7,10,790.0,3510.5789999999997,0.009491920471191406,0.006431102752685547,0.0,3489.4210000000003
191,07:22:00,0,1000,700,1,2,31,24,15,11,16,15,13,11,1387.0,6152.289734896126,0.029412031173706055,0.020846128463745117,0.0,8847.710265103718
195,13:21:00,0,1000,700,1,2,40,42,27,17,17,23,25,17,2556.0,11374.161000000002,0.11288022994995117,0.37998199462890625,0.0,11625.838999999998
194,15:17:30,0.2,1000,700,4,5,48,28,22,11,22,26,17,11,2356.8992931281246,10297.189999999999,0.028079986572265625,0.0047609806060791016,0.0,15702.810000000001
198,19:44:00,0.4,1000,700,3,4,23,13,11,6,8,15,7,6,929.594890837514,3879.101,0.00399470329284668,0.004312992095947266,0.0,11120.899
191,13:41:30,0,1000,700,1,2,23,18,10,10,12,11,8,10,1422.0,6109.509684128704,0.013119220733642578,0.010250091552734375,0.0,4890.490315871296
198,10:24:30,0.4,1000,700,3,4,17,15,9,10,14,3,5,10,747.0,3225.6719999999996,0.004542827606201172,0.0013959407806396484,0.0,-225.67199999999957
155,07:44:30,1,1000,700,12,13,45,24,15,22,32,13,2,22,1868.0,7659.410000000001,0.008142948150634766,0.001255035400390625,0.0,5340.589999999999
155,07:44:30,0,1000,700,1,2,45,34,21,15,16,29,19,15,1926.0,8514.778,0.08309388160705566,0.027571916580200195,0.0,20485.222
191,13:41:30,1,1000,700,14,15,23,11,15,11,18,5,0,11,1422.0,5202.024684128705,0.0028018951416015625,0.0005719661712646484,0.0,-202.0246841287053
198,10:24:30,0.2,1000,700,2,3,17,16,9,10,14,3,6,10,747.0,3225.672,0.004846096038818359,0.0036618709564208984,0.0,-225.6719999999782
198,10:24:30,1,1000,700,7,8,17,12,9,11,15,2,1,11,790.0,2855.7120000000004,0.0021092891693115234,0.0007390975952148438,0.0,-855.7120000000004
195,13:21:00,1,1000,700,22,23,40,27,26,24,30,10,3,24,2468.0,9746.443,0.033197879791259766,0.0021369457244873047,0.0,253.5570000000007
191,07:22:00,1,1000,700,13,14,31,14,16,12,22,9,2,12,1387.0,5095.854734896091,0.003835916519165039,0.0005731582641601562,0.0,3904.145265103909
194,15:17:30,0,1000,700,1,2,48,31,24,9,14,34,22,9,2381.9999999999927,10639.332000000002,0.07119369506835938,0.052848100662231445,0.0,23360.667999999998
198,19:44:00,0.2,1000,700,1,2,23,15,11,6,7,16,9,6,946.0,3955.6100000000006,0.009484052658081055,0.007239818572998047,0.0,12044.39
194,15:17:30,0.4,1000,700,9,10,48,25,22,13,24,24,12,13,2343.0,9398.907,0.011039972305297852,0.0038139820098876953,0.0,14601.093
185,15:27:00,0,1000,700,1,2,26,29,19,12,11,15,17,12,2159.0,9285.613440251229,0.036360979080200195,0.050199031829833984,0.0,5714.3876804485735
195,13:21:00,0.2,1000,700,4,5,40,40,23,22,21,19,18,22,2468.0,10616.565999999999,0.04150509834289551,0.1663370132446289,0.0,8383.434000000001
194,07:10:00,0.2,1000,700,4,5,51,33,24,14,15,36,19,14,2369.1220472440946,10220.586,0.035346031188964844,0.0651540756225586,0.0,25779.414
55,15:58:00,0,1000,700,1,2,71,56,45,13,15,56,43,13,4074.0,18159.206,0.3264729976654053,0.16782903671264648,0.0,37840.794
199,13:24:30,0,1000,700,1,2,30,33,25,10,9,21,23,10,3030.0,13456.511999999999,0.05345916748046875,0.09819698333740234,0.0,7543.488000000001
196,09:57:30,1,1000,700,14,15,15,10,18,7,10,5,3,7,1956.0,7688.5470000000005,0.002251148223876953,0.0008959770202636719,0.0,-2688.5470000000005
185,07:21:00,1,1000,700,28,29,89,35,33,31,51,38,4,31,3435.0,13574.43,0.023368120193481445,0.0016541481018066406,0.0,24425.57
191,07:22:00,0.2,1000,700,2,3,31,24,16,11,19,12,13,11,1358.0,5757.66873489609,0.01743793487548828,0.0460200309753418,0.0,6242.33126510391
199,16:04:00,0.4,1000,700,8,9,43,27,24,12,19,24,15,12,3025.0,12900.686,0.02401590347290039,0.058693885803222656,0.0,11099.314
193,13:30:30,1,1000,700,14,15,48,22,16,21,34,14,1,21,1565.0,6125.9890000000005,0.010608911514282227,0.001293182373046875,0.0,7874.0109999999995
193,13:30:30,0.2,1000,700,3,4,48,30,16,18,29,19,12,18,1589.0,7001.405000000022,0.0540919303894043,0.03223395347595215,0.0,11998.594999999976
199,13:24:30,0.2,1000,700,4,5,30,30,20,15,17,13,15,15,2990.0,11984.777999999998,0.013946771621704102,0.013926982879638672,0.0,1015.2220000000016
192,14:50:30,1,1000,700,14,15,53,30,22,23,38,15,7,23,2090.0,8393.471,0.014168262481689453,0.0021860599517822266,0.0,6606.529
187,16:47:00,0.4,1000,700,12,13,43,44,35,22,21,22,22,22,3299.4557981388716,14354.793,0.03465700149536133,0.0254669189453125,0.0,7645.207
187,13:47:00,1,1000,700,29,30,38,27,35,22,21,17,5,22,3294.0,12707.103000000003,0.009781837463378906,0.0010819435119628906,0.0,4292.896999999997
185,07:21:00,0.2,1000,700,5,6,89,54,39,21,28,61,33,21,3527.0,15555.145,0.11364579200744629,0.09453201293945312,0.0,45444.854999999996
191,13:41:30,0.4,1000,700,6,7,23,14,11,10,15,8,4,10,1381.0,5766.575684128705,0.004999876022338867,0.0025489330291748047,0.0,2233.424315871295
187,13:47:00,0,1000,700,1,2,38,44,34,12,9,29,32,12,3338.0,14461.387999999999,0.11398005485534668,0.17790889739990234,0.0,14538.612000000001
191,07:22:00,0.4,1000,700,5,6,31,21,14,13,21,10,8,13,1358.0,5423.882734896091,0.007843017578125,0.0043599605560302734,0.0,4576.117265103909
199,16:04:00,0.2,1000,700,4,5,43,30,23,12,16,27,18,12,3069.0,13207.301000000001,0.06337714195251465,0.07598090171813965,0.0,13792.698999999999
195,13:21:00,0.4,1000,700,9,10,40,36,22,24,25,15,12,24,2468.0,9517.533000000001,0.023209095001220703,0.020869016647338867,0.0,5482.466999999999
194,07:10:00,0.4,1000,700,9,10,51,29,24,15,18,33,14,15,2369.1220472440946,9920.453999999998,0.029536008834838867,0.054815053939819336,0.0,23079.546000000002
192,14:50:30,0,1000,700,1,2,53,40,21,21,24,29,19,21,2118.0,9385.818,0.12890195846557617,0.3055438995361328,0.0,19614.182
185,07:21:00,0,1000,700,1,2,89,58,41,19,25,64,39,19,3527.0,15636.570365722579,0.4280822277069092,0.25565385818481445,0.0,48363.43051361482
196,09:57:30,0,1000,700,1,2,15,18,17,3,2,13,15,3,1990.4809413027906,8898.246,0.009339094161987305,0.08450198173522949,0.0,4101.754000000001
193,13:30:30,0,1000,700,1,2,48,32,16,18,23,25,14,18,1583.6193746381978,7079.412052382613,0.07769417762756348,0.04657912254333496,0.0,17920.588044009488
185,07:21:00,0.4,1000,700,11,12,89,48,39,21,34,55,27,21,3527.0,15337.58299999999,0.07317590713500977,0.07251405715942383,0.0,39662.41699999994
191,13:41:30,0.2,1000,700,3,4,23,17,12,9,12,11,8,9,1422.0,6109.509684128705,0.008008003234863281,0.0054149627685546875,0.0,4890.490315871295
193,13:30:30,0.4,1000,700,6,7,48,28,17,18,30,18,10,18,1569.2321045096614,6737.3240000000005,0.02100396156311035,0.007938861846923828,0.0,11262.676
199,13:24:30,0.4,1000,700,8,9,30,27,21,15,17,13,12,15,3030.0,11984.777999999998,0.01184701919555664,0.010670185089111328,0.0,1015.2220000000016
199,13:24:30,1,1000,700,19,20,30,20,24,16,18,12,4,16,2990.0,12192.131999999998,0.005763053894042969,0.0014350414276123047,0.0,-192.1319999999978
187,16:47:00,0.2,1000,700,6,7,43,47,37,17,17,26,30,17,3338.0,14712.669,0.03836512565612793,0.020808935165405273,0.0,11287.331
55,15:58:00,1,1000,700,22,23,71,40,27,36,55,16,4,36,4074.0,15644.422000000002,0.030372142791748047,0.002079010009765625,0.0,355.5779999999977
187,16:47:00,1,1000,700,29,30,43,34,37,27,27,16,7,27,3294.0,13123.513999999997,0.013190984725952148,0.0016160011291503906,0.0,2876.4860000000026
185,15:27:00,0.2,1000,700,3,4,26,27,19,12,13,13,15,12,2159.0,9252.3,0.01677107810974121,0.03932690620422363,0.0,3747.7000000000007
192,08:28:00,0.4,1000,700,5,6,33,25,15,16,15,18,9,16,1991.0,8368.284,0.01094198226928711,0.011986970901489258,0.0,9631.716
55,18:56:00,1,1000,700,27,28,58,34,33,29,37,21,5,29,5139.0,19680.796000000002,0.01566910743713379,0.002110004425048828,0.0,1319.203999999998
193,08:16:30,0.4,1000,700,5,6,43,25,16,15,22,21,10,15,1472.0,6100.402,0.016514062881469727,0.004050016403198242,0.0,14899.598
198,19:44:00,1,1000,700,7,8,23,9,10,7,11,12,2,7,946.0,3464.248,0.0021147727966308594,0.0009350776672363281,0.0,8535.752
155,13:50:00,1,1000,700,14,15,32,21,17,19,24,8,2,19,1607.0,6196.468000000001,0.005663871765136719,0.0010819435119628906,0.0,1803.5319999999992
187,13:47:00,0.2,1000,700,6,7,38,41,32,16,13,25,25,16,3338.0,13294.3,0.03260302543640137,0.011220216751098633,0.0,11705.7
196,16:23:30,0,1000,700,1,2,29,23,20,5,5,24,18,5,2060.0,8826.838999999998,0.025925159454345703,0.8850269317626953,0.0,15173.161000000002
194,07:10:00,0,1000,700,1,2,51,36,25,13,14,37,23,13,2372.0,10407.921,0.10196876525878906,0.2448410987854004,0.0,26592.078999999998
192,08:28:00,1,1000,700,12,13,33,18,16,15,16,17,3,15,1966.275724767358,7896.714000000001,0.004968881607055664,0.0010800361633300781,0.0,9103.286
155,13:50:00,0.2,1000,700,3,4,32,26,16,14,17,15,12,14,1646.0,6856.992,0.020599842071533203,0.022578954696655273,0.0,8143.008
193,08:16:30,1,1000,700,13,14,43,18,14,18,32,11,0,18,1444.0,5418.034000000001,0.006400108337402344,0.0006930828094482422,0.0,5581.965999999999
196,16:23:30,1,1000,700,14,15,29,14,17,12,21,8,2,12,1954.0,7484.485000000001,0.004818916320800781,0.0011839866638183594,0.0,515.5149999999994
155,13:50:00,0,1000,700,1,2,32,28,18,12,14,18,16,12,1645.2471772763165,7354.912981296056,0.04114103317260742,0.02172112464904785,0.0,10645.087018703725
193,08:16:30,0,1000,700,1,2,43,29,17,14,21,22,15,14,1472.0,6423.114,0.05666470527648926,0.046148061752319336,0.0,15576.886
192,08:28:00,0,1000,700,1,2,33,29,18,13,12,21,16,13,1991.0,8808.143,0.04401206970214844,0.14147520065307617,0.0,12191.857
194,07:10:00,1,1000,700,22,23,51,19,26,16,28,23,3,16,2334.0,8928.65,0.008951902389526367,0.0011479854583740234,0.0,14071.35
198,19:44:00,0,1000,700,1,2,23,15,11,6,7,16,9,6,946.0,3955.6100000000006,0.009552240371704102,0.006865024566650391,0.0,12044.39
185,15:27:00,0.4,1000,700,7,8,26,25,18,15,17,9,10,15,2127.43450250537,8830.391999999996,0.008407831192016602,0.002974987030029297,0.0,169.6080000000038
192,08:28:00,0.2,1000,700,2,3,33,28,19,12,12,21,16,12,1991.0,8808.142999999998,0.026460886001586914,0.0415189266204834,0.0,12191.857
187,13:47:00,0.4,1000,700,12,13,38,36,29,20,17,21,16,20,3314.5207140300627,12577.065999999999,0.020630836486816406,0.008198022842407227,0.0,8422.934000000001
55,18:56:00,0,1000,700,1,2,58,52,43,11,11,47,41,11,5139.0,22551.705,0.2328472137451172,0.5585269927978516,0.0,24448.295
155,13:50:00,0.4,1000,700,6,7,32,24,16,15,20,12,9,15,1607.0,6894.880999999999,0.010565996170043945,0.016949892044067383,0.0,5105.119000000001
193,08:16:30,0.2,1000,700,2,3,43,28,17,14,21,22,14,14,1472.0,6494.521999999999,0.03455018997192383,0.014313936233520508,0.0,15505.478000000001
187,16:47:00,0,1000,700,1,2,43,52,37,17,17,26,35,17,3338.0,14712.669,0.17613887786865234,1.7695729732513428,0.0,11287.331
55,18:56:00,0.4,1000,700,11,12,58,42,35,19,19,39,23,19,5139.0,22378.581,0.053617000579833984,1.0787549018859863,0.0,16621.419
195,07:09:00,0.4,1000,700,9,10,48,31,22,19,31,17,12,19,2447.0,10167.859999999999,0.02237701416015625,0.010122060775756836,0.0,6832.140000000001
196,16:23:30,0.4,1000,700,6,7,29,20,16,11,12,17,9,11,1954.0,8070.053999999999,0.009073972702026367,0.025722980499267578,0.0,8929.946
199,16:04:00,0,1000,700,1,2,43,33,25,10,14,29,23,10,3069.0,13697.976999999999,0.07292985916137695,0.18747878074645996,0.0,15302.023510617044
192,14:50:30,0.2,1000,700,3,4,53,38,22,20,28,25,18,20,2118.0,9095.5,0.051921844482421875,0.14253687858581543,0.0,15904.5
195,07:09:00,1,1000,700,22,23,48,24,26,21,34,14,3,21,2459.528901216894,9635.070999999998,0.010918855667114258,0.002048969268798828,0.0,4364.929000000002
196,09:57:30,0.4,1000,700,6,7,15,15,18,4,6,9,11,4,1956.0,8197.720000000001,0.002984285354614258,0.0016350746154785156,0.0,802.2799999999988
155,07:44:30,0.2,1000,700,2,3,45,33,19,17,20,25,16,17,1926.0,8477.269,0.0691370964050293,0.0334780216217041,0.0,16522.731
55,15:58:00,0.4,1000,700,9,10,71,50,28,32,48,23,18,32,4126.0,13052.034825117442,0.06267118453979492,0.036167144775390625,0.0,9947.96611268328
196,16:23:30,0.2,1000,700,3,4,29,22,17,9,11,18,13,9,1954.0,8481.369999999999,0.011469125747680664,0.09074902534484863,0.0,9518.630000000001
195,07:09:00,0,1000,700,1,2,48,38,27,13,15,33,25,13,2514.0,10919.939,0.10607290267944336,0.2364790439605713,0.0,22080.061
199,16:04:00,1,1000,700,19,20,43,18,24,14,24,19,4,14,3025.0,12511.964999999998,0.007876157760620117,0.0023648738861083984,0.0,6488.035000000002
55,18:56:00,0.2,1000,700,5,6,58,48,44,10,11,47,38,10,5139.0,22730.953000000005,0.11887598037719727,0.62186598777771,0.0,24269.046999999995
195,07:09:00,0.2,1000,700,4,5,48,35,25,15,22,26,20,15,2514.0,10751.147999999986,0.041749000549316406,0.18810701370239258,0.0,15248.851999999975
196,09:57:30,0.2,1000,700,3,4,15,16,17,3,4,11,13,3,2020.0,8184.095,0.003819704055786133,0.009030818939208984,0.0,2815.9049999999997
155,07:44:30,0.4,1000,700,5,6,45,30,17,19,25,20,11,19,1926.0,8149.008000000002,0.03517794609069824,0.018602848052978516,0.0,11850.991999999998
55,15:58:00,0.2,1000,700,4,5,71,53,34,24,32,39,29,24,4126.0,15916.992,0.0862112045288086,0.06621503829956055,0.0,23083.008
192,14:50:30,0.4,1000,700,6,7,53,36,24,19,29,24,17,19,2118.0,9008.505000000001,0.02526378631591797,0.013041973114013672,0.0,14991.494999999999
194,15:17:30,1,1000,700,22,23,48,17,25,15,25,23,2,15,2343.0,9042.614999999998,0.008292913436889648,0.0012340545654296875,0.0,13957.385000000002
185,15:27:00,1,1000,700,17,18,26,18,23,13,20,6,5,13,2113.0,8614.527999999998,0.004477739334106445,0.0009629726409912109,0.0,-2614.5279999999984
198,10:24:30,0,1000,700,1,2,17,17,9,10,10,7,7,10,790.0,3510.5789999999997,0.009861946105957031,0.006757974624633789,0.0,3489.4210000000003
191,07:22:00,0,1000,700,1,2,31,24,15,11,16,15,13,11,1387.0,6152.289734896126,0.02977919578552246,0.022281885147094727,0.0,8847.710265103718
195,13:21:00,0,1000,700,1,2,40,42,27,17,17,23,25,17,2556.0,11374.161000000002,0.10829281806945801,0.37525391578674316,0.0,11625.838999999998
194,15:17:30,0.2,1000,700,4,5,48,28,22,11,22,26,17,11,2356.8992931281246,10297.189999999999,0.027338027954101562,0.0043070316314697266,0.0,15702.810000000001
198,19:44:00,0.4,1000,700,3,4,23,13,11,6,8,15,7,6,929.594890837514,3879.101,0.003874063491821289,0.004058837890625,0.0,11120.899
191,13:41:30,0,1000,700,1,2,23,18,10,10,12,11,8,10,1422.0,6109.509684128704,0.013415813446044922,0.01123809814453125,0.0,4890.490315871296
198,10:24:30,0.4,1000,700,3,4,17,15,9,10,14,3,5,10,747.0,3225.6719999999996,0.0047321319580078125,0.0016961097717285156,0.0,-225.67199999999957
155,07:44:30,1,1000,700,12,13,45,24,15,22,32,13,2,22,1868.0,7659.410000000001,0.008432149887084961,0.0015079975128173828,0.0,5340.589999999999
155,07:44:30,0,1000,700,1,2,45,34,21,15,16,29,19,15,1926.0,8514.778,0.08017921447753906,0.027401208877563477,0.0,20485.222
191,13:41:30,1,1000,700,14,15,23,11,15,11,18,5,0,11,1422.0,5202.024684128705,0.0026769638061523438,0.0005199909210205078,0.0,-202.0246841287053
198,10:24:30,0.2,1000,700,2,3,17,16,9,10,14,3,6,10,747.0,3225.672,0.004807233810424805,0.003740072250366211,0.0,-225.6719999999782
198,10:24:30,1,1000,700,7,8,17,12,9,11,15,2,1,11,790.0,2855.7120000000004,0.0020067691802978516,0.0006849765777587891,0.0,-855.7120000000004
195,13:21:00,1,1000,700,22,23,40,27,26,24,30,10,3,24,2468.0,9746.443,0.031155109405517578,0.0020558834075927734,0.0,253.5570000000007
191,07:22:00,1,1000,700,13,14,31,14,16,12,22,9,2,12,1387.0,5095.854734896091,0.0038373470306396484,0.0005218982696533203,0.0,3904.145265103909
194,15:17:30,0,1000,700,1,2,48,31,24,9,14,34,22,9,2381.9999999999927,10639.332000000002,0.07024788856506348,0.05072283744812012,0.0,23360.667999999998
198,19:44:00,0.2,1000,700,1,2,23,15,11,6,7,16,9,6,946.0,3955.6100000000006,0.009544134140014648,0.007676124572753906,0.0,12044.39
194,15:17:30,0.4,1000,700,9,10,48,25,22,13,24,24,12,13,2343.0,9398.907,0.010933160781860352,0.004317045211791992,0.0,14601.093
185,15:27:00,0,1000,700,1,2,26,29,19,12,11,15,17,12,2159.0,9285.613440251229,0.0356137752532959,0.0481870174407959,0.0,5714.3876804485735
195,13:21:00,0.2,1000,700,4,5,40,40,23,22,21,19,18,22,2468.0,10616.565999999999,0.04153299331665039,0.17298603057861328,0.0,8383.434000000001
194,07:10:00,0.2,1000,700,4,5,51,33,24,14,15,36,19,14,2369.1220472440946,10220.586,0.03491401672363281,0.06530904769897461,0.0,25779.414
55,15:58:00,0,1000,700,1,2,71,56,45,13,15,56,43,13,4074.0,18159.206,0.32041501998901367,0.16897201538085938,0.0,37840.794
199,13:24:30,0,1000,700,1,2,30,33,25,10,9,21,23,10,3030.0,13456.511999999999,0.05197715759277344,0.09875607490539551,0.0,7543.488000000001
196,09:57:30,1,1000,700,14,15,15,10,18,7,10,5,3,7,1956.0,7688.5470000000005,0.002221822738647461,0.0008859634399414062,0.0,-2688.5470000000005
185,07:21:00,1,1000,700,28,29,89,35,33,31,51,38,4,31,3435.0,13574.43,0.022513151168823242,0.0017409324645996094,0.0,24425.57
191,07:22:00,0.2,1000,700,2,3,31,24,16,11,19,12,13,11,1358.0,5757.66873489609,0.017491817474365234,0.04645204544067383,0.0,6242.33126510391
199,16:04:00,0.4,1000,700,8,9,43,27,24,12,19,24,15,12,3025.0,12900.686,0.023449182510375977,0.05795097351074219,0.0,11099.314
193,13:30:30,1,1000,700,14,15,48,22,16,21,34,14,1,21,1565.0,6125.9890000000005,0.01117706298828125,0.0013689994812011719,0.0,7874.0109999999995
193,13:30:30,0.2,1000,700,3,4,48,30,16,18,29,19,12,18,1589.0,7001.405000000022,0.05324220657348633,0.03196287155151367,0.0,11998.594999999976
199,13:24:30,0.2,1000,700,4,5,30,30,20,15,17,13,15,15,2990.0,11984.777999999998,0.01420903205871582,0.013983964920043945,0.0,1015.2220000000016
192,14:50:30,1,1000,700,14,15,53,30,22,23,38,15,7,23,2090.0,8393.471,0.013906002044677734,0.002379894256591797,0.0,6606.529
187,16:47:00,0.4,1000,700,12,13,43,44,35,22,21,22,22,22,3299.4557981388716,14354.793,0.03378605842590332,0.025735139846801758,0.0,7645.207
187,13:47:00,1,1000,700,29,30,38,27,35,22,21,17,5,22,3294.0,12707.103000000003,0.009919881820678711,0.0012600421905517578,0.0,4292.896999999997
185,07:21:00,0.2,1000,700,5,6,89,54,39,21,28,61,33,21,3527.0,15555.145,0.11286306381225586,0.09700202941894531,0.0,45444.854999999996
191,13:41:30,0.4,1000,700,6,7,23,14,11,10,15,8,4,10,1381.0,5766.575684128705,0.004935026168823242,0.0024428367614746094,0.0,2233.424315871295
187,13:47:00,0,1000,700,1,2,38,44,34,12,9,29,32,12,3338.0,14461.387999999999,0.11268782615661621,0.1815488338470459,0.0,14538.612000000001
191,07:22:00,0.4,1000,700,5,6,31,21,14,13,21,10,8,13,1358.0,5423.882734896091,0.007850170135498047,0.004111051559448242,0.0,4576.117265103909
199,16:04:00,0.2,1000,700,4,5,43,30,23,12,16,27,18,12,3069.0,13207.301000000001,0.06197190284729004,0.07490897178649902,0.0,13792.698999999999
195,13:21:00,0.4,1000,700,9,10,40,36,22,24,25,15,12,24,2468.0,9517.533000000001,0.022803068161010742,0.02144789695739746,0.0,5482.466999999999
194,07:10:00,0.4,1000,700,9,10,51,29,24,15,18,33,14,15,2369.1220472440946,9920.453999999998,0.030668020248413086,0.05570507049560547,0.0,23079.546000000002
192,14:50:30,0,1000,700,1,2,53,40,21,21,24,29,19,21,2118.0,9385.818,0.1270601749420166,0.302886962890625,0.0,19614.182
185,07:21:00,0,1000,700,1,2,89,58,41,19,25,64,39,19,3527.0,15636.570365722579,0.42478275299072266,0.25629401206970215,0.0,48363.43051361482
196,09:57:30,0,1000,700,1,2,15,18,17,3,2,13,15,3,1990.4809413027906,8898.246,0.009386062622070312,0.0861349105834961,0.0,4101.754000000001
193,13:30:30,0,1000,700,1,2,48,32,16,18,23,25,14,18,1583.6193746381978,7079.412052382613,0.07513976097106934,0.04552316665649414,0.0,17920.588044009488
185,07:21:00,0.4,1000,700,11,12,89,48,39,21,34,55,27,21,3527.0,15337.58299999999,0.07134795188903809,0.07202601432800293,0.0,39662.41699999994
191,13:41:30,0.2,1000,700,3,4,23,17,12,9,12,11,8,9,1422.0,6109.509684128705,0.008192062377929688,0.00576019287109375,0.0,4890.490315871295
193,13:30:30,0.4,1000,700,6,7,48,28,17,18,30,18,10,18,1569.2321045096614,6737.3240000000005,0.02108311653137207,0.007816076278686523,0.0,11262.676
199,13:24:30,0.4,1000,700,8,9,30,27,21,15,17,13,12,15,3030.0,11984.777999999998,0.011453866958618164,0.010754823684692383,0.0,1015.2220000000016
199,13:24:30,1,1000,700,19,20,30,20,24,16,18,12,4,16,2990.0,12192.131999999998,0.0058040618896484375,0.0014820098876953125,0.0,-192.1319999999978
187,16:47:00,0.2,1000,700,6,7,43,47,37,17,17,26,30,17,3338.0,14712.669,0.038854122161865234,0.020907163619995117,0.0,11287.331
55,15:58:00,1,1000,700,22,23,71,40,27,36,55,16,4,36,4074.0,15644.422000000002,0.028853893280029297,0.002125978469848633,0.0,355.5779999999977
187,16:47:00,1,1000,700,29,30,43,34,37,27,27,16,7,27,3294.0,13123.513999999997,0.012840986251831055,0.0015339851379394531,0.0,2876.4860000000026
185,15:27:00,0.2,1000,700,3,4,26,27,19,12,13,13,15,12,2159.0,9252.3,0.016416072845458984,0.0390169620513916,0.0,3747.7000000000007
192,08:28:00,0.4,1000,700,5,6,33,25,15,16,15,18,9,16,1991.0,8368.284,0.010851860046386719,0.012005090713500977,0.0,9631.716
55,18:56:00,1,1000,700,27,28,58,34,33,29,37,21,5,29,5139.0,19680.796000000002,0.015853166580200195,0.002279996871948242,0.0,1319.203999999998
193,08:16:30,0.4,1000,700,5,6,43,25,16,15,22,21,10,15,1472.0,6100.402,0.016410112380981445,0.004230022430419922,0.0,14899.598
198,19:44:00,1,1000,700,7,8,23,9,10,7,11,12,2,7,946.0,3464.248,0.0020759105682373047,0.0010020732879638672,0.0,8535.752
155,13:50:00,1,1000,700,14,15,32,21,17,19,24,8,2,19,1607.0,6196.468000000001,0.00568699836730957,0.0010960102081298828,0.0,1803.5319999999992
187,13:47:00,0.2,1000,700,6,7,38,41,32,16,13,25,25,16,3338.0,13294.3,0.03268313407897949,0.011481046676635742,0.0,11705.7
196,16:23:30,0,1000,700,1,2,29,23,20,5,5,24,18,5,2060.0,8826.838999999998,0.025789976119995117,0.9067521095275879,0.0,15173.161000000002
194,07:10:00,0,1000,700,1,2,51,36,25,13,14,37,23,13,2372.0,10407.921,0.10037803649902344,0.2614269256591797,0.0,26592.078999999998
192,08:28:00,1,1000,700,12,13,33,18,16,15,16,17,3,15,1966.275724767358,7896.714000000001,0.005513191223144531,0.0013880729675292969,0.0,9103.286
155,13:50:00,0.2,1000,700,3,4,32,26,16,14,17,15,12,14,1646.0,6856.992,0.02172708511352539,0.025712966918945312,0.0,8143.008
193,08:16:30,1,1000,700,13,14,43,18,14,18,32,11,0,18,1444.0,5418.034000000001,0.0067059993743896484,0.0008320808410644531,0.0,5581.965999999999
196,16:23:30,1,1000,700,14,15,29,14,17,12,21,8,2,12,1954.0,7484.485000000001,0.009193897247314453,0.03485298156738281,0.0,515.5149999999994
155,13:50:00,0,1000,700,1,2,32,28,18,12,14,18,16,12,1645.2471772763165,7354.912981296056,0.05630612373352051,0.03339099884033203,0.0,10645.087018703725
193,08:16:30,0,1000,700,1,2,43,29,17,14,21,22,15,14,1472.0,6423.114,0.08612680435180664,0.18276500701904297,0.0,15576.886
192,08:28:00,0,1000,700,1,2,33,29,18,13,12,21,16,13,1991.0,8808.143,0.05291008949279785,0.14768099784851074,0.0,12191.857
194,07:10:00,1,1000,700,22,23,51,19,26,16,28,23,3,16,2334.0,8928.65,0.009248971939086914,0.001077890396118164,0.0,14071.35
198,19:44:00,0,1000,700,1,2,23,15,11,6,7,16,9,6,946.0,3955.6100000000006,0.009858131408691406,0.007524013519287109,0.0,12044.39
185,15:27:00,0.4,1000,700,7,8,26,25,18,15,17,9,10,15,2127.43450250537,8830.391999999996,0.008563995361328125,0.003329038619995117,0.0,169.6080000000038
192,08:28:00,0.2,1000,700,2,3,33,28,19,12,12,21,16,12,1991.0,8808.142999999998,0.026766300201416016,0.04017210006713867,0.0,12191.857
187,13:47:00,0.4,1000,700,12,13,38,36,29,20,17,21,16,20,3314.5207140300627,12577.065999999999,0.020766019821166992,0.008394002914428711,0.0,8422.934000000001
55,18:56:00,0,1000,700,1,2,58,52,43,11,11,47,41,11,5139.0,22551.705,0.233292818069458,0.5556759834289551,0.0,24448.295
155,13:50:00,0.4,1000,700,6,7,32,24,16,15,20,12,9,15,1607.0,6894.880999999999,0.010439872741699219,0.018060922622680664,0.0,5105.119000000001
193,08:16:30,0.2,1000,700,2,3,43,28,17,14,21,22,14,14,1472.0,6494.521999999999,0.03415727615356445,0.014171838760375977,0.0,15505.478000000001
187,16:47:00,0,1000,700,1,2,43,52,37,17,17,26,35,17,3338.0,14712.669,0.17915081977844238,1.8458530902862549,0.0,11287.331
