route,route_starting_time,percentage_of_compulsory_stops,benefit,walking_distance,num_segments,compulsory_stops,requests,number_optional_stops,used_nodes,unused_nodes,unserved_requests,served_requests,opt_stops_visited,opt_stops_not_visited,total_used-travel_time,travel_distance,build_time,solve_time,optimality_gap,obj_val
55,18:56:00,0.4,1000,700,11,12,58,42,35,19,19,39,23,19,5139.0,22378.581,0.05668997764587402,1.0975360870361328,0.0,16621.419
195,07:09:00,0.4,1000,700,9,10,48,31,22,19,31,17,12,19,2447.0,10167.859999999999,0.021763086318969727,0.009804010391235352,0.0,6832.140000000001
196,16:23:30,0.4,1000,700,6,7,29,20,16,11,12,17,9,11,1954.0,8070.053999999999,0.008998870849609375,0.021447181701660156,0.0,8929.946
199,16:04:00,0,1000,700,1,2,43,33,25,10,14,29,23,10,3069.0,13697.976999999999,0.07508587837219238,0.1926560401916504,0.0,15302.023510617044
192,14:50:30,0.2,1000,700,3,4,53,38,22,20,28,25,18,20,2118.0,9095.5,0.05337691307067871,0.1408698558807373,0.0,15904.5
195,07:09:00,1,1000,700,22,23,48,24,26,21,34,14,3,21,2459.528901216894,9635.070999999998,0.011140823364257812,0.0020689964294433594,0.0,4364.929000000002
196,09:57:30,0.4,1000,700,6,7,15,15,18,4,6,9,11,4,1956.0,8197.720000000001,0.002863168716430664,0.0013959407806396484,0.0,802.2799999999988
155,07:44:30,0.2,1000,700,2,3,45,33,19,17,20,25,16,17,1926.0,8477.269,0.06917405128479004,0.034731149673461914,0.0,16522.731
55,15:58:00,0.4,1000,700,9,10,71,50,28,32,48,23,18,32,4126.0,13052.034825117442,0.06325912475585938,0.03415203094482422,0.0,9947.96611268328
196,16:23:30,0.2,1000,700,3,4,29,22,17,9,11,18,13,9,1954.0,8481.369999999999,0.011688947677612305,0.08826112747192383,0.0,9518.630000000001
195,07:09:00,0,1000,700,1,2,48,38,27,13,15,33,25,13,2514.0,10919.939,0.10707616806030273,0.23462510108947754,0.0,22080.061
199,16:04:00,1,1000,700,19,20,43,18,24,14,24,19,4,14,3025.0,12511.964999999998,0.00818777084350586,0.002485990524291992,0.0,6488.035000000002
55,18:56:00,0.2,1000,700,5,6,58,48,44,10,11,47,38,10,5139.0,22730.953000000005,0.12113404273986816,0.6141350269317627,0.0,24269.046999999995
195,07:09:00,0.2,1000,700,4,5,48,35,25,15,22,26,20,15,2514.0,10751.147999999986,0.041174888610839844,0.18165993690490723,0.0,15248.851999999975
196,09:57:30,0.2,1000,700,3,4,15,16,17,3,4,11,13,3,2020.0,8184.095,0.003913164138793945,0.009024858474731445,0.0,2815.9049999999997
155,07:44:30,0.4,1000,700,5,6,45,30,17,19,25,20,11,19,1926.0,8149.008000000002,0.03579282760620117,0.018919944763183594,0.0,11850.991999999998
55,15:58:00,0.2,1000,700,4,5,71,53,34,24,32,39,29,24,4126.0,15916.992,0.08620119094848633,0.06491494178771973,0.0,23083.008
192,14:50:30,0.4,1000,700,6,7,53,36,24,19,29,24,17,19,2118.0,9008.505000000001,0.024374961853027344,0.012398958206176758,0.0,14991.494999999999
194,15:17:30,1,1000,700,22,23,48,17,25,15,25,23,2,15,2343.0,9042.614999999998,0.008226156234741211,0.0012099742889404297,0.0,13957.385000000002
185,15:27:00,1,1000,700,17,18,26,18,23,13,20,6,5,13,2113.0,8614.527999999998,0.004607200622558594,0.0009670257568359375,0.0,-2614.5279999999984
198,10:24:30,0,1000,700,1,2,17,17,9,10,10,7,7,10,790.0,3510.5789999999997,0.009245157241821289,0.006289005279541016,0.0,3489.4210000000003
191,07:22:00,0,1000,700,1,2,31,24,15,11,16,15,13,11,1387.0,6152.289734896126,0.02908802032470703,0.021528959274291992,0.0,8847.710265103718
195,13:21:00,0,1000,700,1,2,40,42,27,17,17,23,25,17,2556.0,11374.161000000002,0.11001300811767578,0.37628602981567383,0.0,11625.838999999998
194,15:17:30,0.2,1000,700,4,5,48,28,22,11,22,26,17,11,2356.8992931281246,10297.189999999999,0.026935100555419922,0.004313945770263672,0.0,15702.810000000001
198,19:44:00,0.4,1000,700,3,4,23,13,11,6,8,15,7,6,929.594890837514,3879.101,0.004008769989013672,0.0038461685180664062,0.0,11120.899
191,13:41:30,0,1000,700,1,2,23,18,10,10,12,11,8,10,1422.0,6109.509684128704,0.01341390609741211,0.01147913932800293,0.0,4890.490315871296
198,10:24:30,0.4,1000,700,3,4,17,15,9,10,14,3,5,10,747.0,3225.6719999999996,0.0047550201416015625,0.0017309188842773438,0.0,-225.67199999999957
155,07:44:30,1,1000,700,12,13,45,24,15,22,32,13,2,22,1868.0,7659.410000000001,0.008116006851196289,0.00127410888671875,0.0,5340.589999999999
155,07:44:30,0,1000,700,1,2,45,34,21,15,16,29,19,15,1926.0,8514.778,0.08027791976928711,0.029434919357299805,0.0,20485.222
191,13:41:30,1,1000,700,14,15,23,11,15,11,18,5,0,11,1422.0,5202.024684128705,0.0028553009033203125,0.0005340576171875,0.0,-202.0246841287053
198,10:24:30,0.2,1000,700,2,3,17,16,9,10,14,3,6,10,747.0,3225.672,0.004848957061767578,0.0037369728088378906,0.0,-225.6719999999782
198,10:24:30,1,1000,700,7,8,17,12,9,11,15,2,1,11,790.0,2855.7120000000004,0.0019230842590332031,0.0006959438323974609,0.0,-855.7120000000004
195,13:21:00,1,1000,700,22,23,40,27,26,24,30,10,3,24,2468.0,9746.443,0.0295870304107666,0.002045869827270508,0.0,253.5570000000007
191,07:22:00,1,1000,700,13,14,31,14,16,12,22,9,2,12,1387.0,5095.854734896091,0.003994941711425781,0.0008080005645751953,0.0,3904.145265103909
194,15:17:30,0,1000,700,1,2,48,31,24,9,14,34,22,9,2381.9999999999927,10639.332000000002,0.07224297523498535,0.05107402801513672,0.0,23360.667999999998
198,19:44:00,0.2,1000,700,1,2,23,15,11,6,7,16,9,6,946.0,3955.6100000000006,0.009839057922363281,0.007718086242675781,0.0,12044.39
194,15:17:30,0.4,1000,700,9,10,48,25,22,13,24,24,12,13,2343.0,9398.907,0.014140129089355469,0.00840306282043457,0.0,14601.093
185,15:27:00,0,1000,700,1,2,26,29,19,12,11,15,17,12,2159.0,9285.613440251229,0.03576493263244629,0.04743003845214844,0.0,5714.3876804485735
195,13:21:00,0.2,1000,700,4,5,40,40,23,22,21,19,18,22,2468.0,10616.565999999999,0.04234123229980469,0.17159795761108398,0.0,8383.434000000001
194,07:10:00,0.2,1000,700,4,5,51,33,24,14,15,36,19,14,2369.1220472440946,10220.586,0.03449702262878418,0.06361794471740723,0.0,25779.414
55,15:58:00,0,1000,700,1,2,71,56,45,13,15,56,43,13,4074.0,18159.206,0.3247959613800049,0.1689589023590088,0.0,37840.794
199,13:24:30,0,1000,700,1,2,30,33,25,10,9,21,23,10,3030.0,13456.511999999999,0.053727149963378906,0.09838199615478516,0.0,7543.488000000001
196,09:57:30,1,1000,700,14,15,15,10,18,7,10,5,3,7,1956.0,7688.5470000000005,0.0023059844970703125,0.0008180141448974609,0.0,-2688.5470000000005
185,07:21:00,1,1000,700,28,29,89,35,33,31,51,38,4,31,3435.0,13574.43,0.02378702163696289,0.0019218921661376953,0.0,24425.57
191,07:22:00,0.2,1000,700,2,3,31,24,16,11,19,12,13,11,1358.0,5757.66873489609,0.017466068267822266,0.046864986419677734,0.0,6242.33126510391
199,16:04:00,0.4,1000,700,8,9,43,27,24,12,19,24,15,12,3025.0,12900.686,0.024133920669555664,0.057502031326293945,0.0,11099.314
193,13:30:30,1,1000,700,14,15,48,22,16,21,34,14,1,21,1565.0,6125.9890000000005,0.010685920715332031,0.0012421607971191406,0.0,7874.0109999999995
193,13:30:30,0.2,1000,700,3,4,48,30,16,18,29,19,12,18,1589.0,7001.405000000022,0.05382704734802246,0.03266787528991699,0.0,11998.594999999976
199,13:24:30,0.2,1000,700,4,5,30,30,20,15,17,13,15,15,2990.0,11984.777999999998,0.013860940933227539,0.013946056365966797,0.0,1015.2220000000016
192,14:50:30,1,1000,700,14,15,53,30,22,23,38,15,7,23,2090.0,8393.471,0.014113187789916992,0.002444028854370117,0.0,6606.529
187,16:47:00,0.4,1000,700,12,13,43,44,35,22,21,22,22,22,3299.4557981388716,14354.793,0.033985137939453125,0.02536797523498535,0.0,7645.207
187,13:47:00,1,1000,700,29,30,38,27,35,22,21,17,5,22,3294.0,12707.103000000003,0.009660959243774414,0.0011780261993408203,0.0,4292.896999999997
185,07:21:00,0.2,1000,700,5,6,89,54,39,21,28,61,33,21,3527.0,15555.145,0.11325502395629883,0.09821701049804688,0.0,45444.854999999996
191,13:41:30,0.4,1000,700,6,7,23,14,11,10,15,8,4,10,1381.0,5766.575684128705,0.004931926727294922,0.002560138702392578,0.0,2233.424315871295
187,13:47:00,0,1000,700,1,2,38,44,34,12,9,29,32,12,3338.0,14461.387999999999,0.11332893371582031,0.18271398544311523,0.0,14538.612000000001
191,07:22:00,0.4,1000,700,5,6,31,21,14,13,21,10,8,13,1358.0,5423.882734896091,0.00817108154296875,0.004925966262817383,0.0,4576.117265103909
199,16:04:00,0.2,1000,700,4,5,43,30,23,12,16,27,18,12,3069.0,13207.301000000001,0.06498885154724121,0.07586479187011719,0.0,13792.698999999999
195,13:21:00,0.4,1000,700,9,10,40,36,22,24,25,15,12,24,2468.0,9517.533000000001,0.023156166076660156,0.021365880966186523,0.0,5482.466999999999
194,07:10:00,0.4,1000,700,9,10,51,29,24,15,18,33,14,15,2369.1220472440946,9920.453999999998,0.029420852661132812,0.05531597137451172,0.0,23079.546000000002
192,14:50:30,0,1000,700,1,2,53,40,21,21,24,29,19,21,2118.0,9385.818,0.12885785102844238,0.30676984786987305,0.0,19614.182
185,07:21:00,0,1000,700,1,2,89,58,41,19,25,64,39,19,3527.0,15636.570365722579,0.4318580627441406,0.2592010498046875,0.0,48363.43051361482
196,09:57:30,0,1000,700,1,2,15,18,17,3,2,13,15,3,1990.4809413027906,8898.246,0.009233236312866211,0.0827629566192627,0.0,4101.754000000001
193,13:30:30,0,1000,700,1,2,48,32,16,18,23,25,14,18,1583.6193746381978,7079.412052382613,0.07689499855041504,0.045085906982421875,0.0,17920.588044009488
185,07:21:00,0.4,1000,700,11,12,89,48,39,21,34,55,27,21,3527.0,15337.58299999999,0.07332801818847656,0.07473421096801758,0.0,39662.41699999994
191,13:41:30,0.2,1000,700,3,4,23,17,12,9,12,11,8,9,1422.0,6109.509684128705,0.007977008819580078,0.005413055419921875,0.0,4890.490315871295
193,13:30:30,0.4,1000,700,6,7,48,28,17,18,30,18,10,18,1569.2321045096614,6737.3240000000005,0.0209810733795166,0.008248090744018555,0.0,11262.676
199,13:24:30,0.4,1000,700,8,9,30,27,21,15,17,13,12,15,3030.0,11984.777999999998,0.011738061904907227,0.010421991348266602,0.0,1015.2220000000016
199,13:24:30,1,1000,700,19,20,30,20,24,16,18,12,4,16,2990.0,12192.131999999998,0.005803108215332031,0.0014040470123291016,0.0,-192.1319999999978
187,16:47:00,0.2,1000,700,6,7,43,47,37,17,17,26,30,17,3338.0,14712.669,0.03932309150695801,0.021742820739746094,0.0,11287.331
55,15:58:00,1,1000,700,22,23,71,40,27,36,55,16,4,36,4074.0,15644.422000000002,0.02898883819580078,0.0020880699157714844,0.0,355.5779999999977
187,16:47:00,1,1000,700,29,30,43,34,37,27,27,16,7,27,3294.0,13123.513999999997,0.012722253799438477,0.0016689300537109375,0.0,2876.4860000000026
185,15:27:00,0.2,1000,700,3,4,26,27,19,12,13,13,15,12,2159.0,9252.3,0.016851186752319336,0.040496826171875,0.0,3747.7000000000007
192,08:28:00,0.4,1000,700,5,6,33,25,15,16,15,18,9,16,1991.0,8368.284,0.011053085327148438,0.012060880661010742,0.0,9631.716
55,18:56:00,1,1000,700,27,28,58,34,33,29,37,21,5,29,5139.0,19680.796000000002,0.01634502410888672,0.0024881362915039062,0.0,1319.203999999998
193,08:16:30,0.4,1000,700,5,6,43,25,16,15,22,21,10,15,1472.0,6100.402,0.01592397689819336,0.003927946090698242,0.0,14899.598
198,19:44:00,1,1000,700,7,8,23,9,10,7,11,12,2,7,946.0,3464.248,0.0020749568939208984,0.0021991729736328125,0.0,8535.752
155,13:50:00,1,1000,700,14,15,32,21,17,19,24,8,2,19,1607.0,6196.468000000001,0.005697965621948242,0.0011208057403564453,0.0,1803.5319999999992
187,13:47:00,0.2,1000,700,6,7,38,41,32,16,13,25,25,16,3338.0,13294.3,0.0335230827331543,0.011626005172729492,0.0,11705.7
196,16:23:30,0,1000,700,1,2,29,23,20,5,5,24,18,5,2060.0,8826.838999999998,0.025273799896240234,0.8790590763092041,0.0,15173.161000000002
194,07:10:00,0,1000,700,1,2,51,36,25,13,14,37,23,13,2372.0,10407.921,0.10134410858154297,0.24330496788024902,0.0,26592.078999999998
192,08:28:00,1,1000,700,12,13,33,18,16,15,16,17,3,15,1966.275724767358,7896.714000000001,0.004884958267211914,0.001096963882446289,0.0,9103.286
155,13:50:00,0.2,1000,700,3,4,32,26,16,14,17,15,12,14,1646.0,6856.992,0.020381927490234375,0.0294189453125,0.0,8143.008
193,08:16:30,1,1000,700,13,14,43,18,14,18,32,11,0,18,1444.0,5418.034000000001,0.00629878044128418,0.0007839202880859375,0.0,5581.965999999999
196,16:23:30,1,1000,700,14,15,29,14,17,12,21,8,2,12,1954.0,7484.485000000001,0.004983186721801758,0.0012218952178955078,0.0,515.5149999999994
155,13:50:00,0,1000,700,1,2,32,28,18,12,14,18,16,12,1645.2471772763165,7354.912981296056,0.04073071479797363,0.02187490463256836,0.0,10645.087018703725
193,08:16:30,0,1000,700,1,2,43,29,17,14,21,22,15,14,1472.0,6423.114,0.0570528507232666,0.04857897758483887,0.0,15576.886
192,08:28:00,0,1000,700,1,2,33,29,18,13,12,21,16,13,1991.0,8808.143,0.044182777404785156,0.14327311515808105,0.0,12191.857
194,07:10:00,1,1000,700,22,23,51,19,26,16,28,23,3,16,2334.0,8928.65,0.009030818939208984,0.001074075698852539,0.0,14071.35
198,19:44:00,0,1000,700,1,2,23,15,11,6,7,16,9,6,946.0,3955.6100000000006,0.00952601432800293,0.007484912872314453,0.0,12044.39
185,15:27:00,0.4,1000,700,7,8,26,25,18,15,17,9,10,15,2127.43450250537,8830.391999999996,0.008532047271728516,0.0036029815673828125,0.0,169.6080000000038
192,08:28:00,0.2,1000,700,2,3,33,28,19,12,12,21,16,12,1991.0,8808.142999999998,0.026205778121948242,0.04084491729736328,0.0,12191.857
187,13:47:00,0.4,1000,700,12,13,38,36,29,20,17,21,16,20,3314.5207140300627,12577.065999999999,0.020274877548217773,0.008396148681640625,0.0,8422.934000000001
55,18:56:00,0,1000,700,1,2,58,52,43,11,11,47,41,11,5139.0,22551.705,0.23329806327819824,0.561622142791748,0.0,24448.295
155,13:50:00,0.4,1000,700,6,7,32,24,16,15,20,12,9,15,1607.0,6894.880999999999,0.01032114028930664,0.017777204513549805,0.0,5105.119000000001
193,08:16:30,0.2,1000,700,2,3,43,28,17,14,21,22,14,14,1472.0,6494.521999999999,0.0348658561706543,0.014335155487060547,0.0,15505.478000000001
187,16:47:00,0,1000,700,1,2,43,52,37,17,17,26,35,17,3338.0,14712.669,0.17635726928710938,1.7771801948547363,0.0,11287.331
