route,route_starting_time,percentage_of_compulsory_stops,benefit,walking_distance,num_segments,compulsory_stops,requests,number_optional_stops,used_nodes,unused_nodes,unserved_requests,served_requests,opt_stops_visited,opt_stops_not_visited,total_used-travel_time,travel_distance,build_time,solve_time,optimality_gap,obj_val
187,13:47:00,0.4,1000,700,12,13,40,33,24,22,25,15,11,22,3338.0,12471.777999999975,0.03065013885498047,0.019695043563842773,0.0,2528.2219999998824
191,13:41:30,0.4,1000,700,6,7,22,19,13,13,11,11,6,13,1381.0,5520.904684128705,0.006844043731689453,0.0031709671020507812,0.0,5479.095315871295
192,14:50:30,0.4,1000,700,6,7,53,38,23,22,26,27,16,22,2090.0,9110.018,0.031076908111572266,0.030791044235229492,0.0,17889.982
55,18:56:00,0,1000,700,1,2,58,60,48,14,11,47,46,14,5117.763063707942,22878.448,0.3274672031402588,3.783867120742798,0.0,24121.552
185,07:21:00,0.2,1000,700,5,6,88,61,36,31,40,48,30,31,3527.0,15315.848000000002,0.15208911895751953,0.07863688468933105,0.0,32684.152
55,18:56:00,0.4,1000,700,11,12,58,42,35,19,19,39,23,19,5139.0,22378.581,0.04089713096618652,1.0722601413726807,0.0,16621.419
187,13:47:00,1,1000,700,29,30,37,26,35,21,26,11,5,21,3294.0,13244.141,0.009824991226196289,0.0013849735260009766,0.0,-2244.1409999999996
195,07:09:00,0.4,1000,700,9,10,48,31,22,19,31,17,12,19,2447.0,10167.859999999999,0.021497011184692383,0.010436058044433594,0.0,6832.140000000001
55,18:56:00,1,1000,700,27,28,62,36,35,29,38,24,7,29,5105.0,20111.424000000003,0.01941704750061035,0.004305124282836914,0.0,3888.5759999999973
155,13:50:00,0.4,1000,700,6,7,30,23,14,16,22,8,7,16,1607.0,6711.464999999999,0.010138750076293945,0.01209878921508789,0.0,1288.5350000000008
192,08:28:00,0.4,1000,700,5,6,34,29,20,15,17,17,14,15,1991.0,8616.979,0.013089179992675781,0.015866994857788086,0.0,8383.021
193,08:16:30,0.2,1000,700,2,3,43,31,15,19,24,19,12,19,1472.0,6456.620999999999,0.044081926345825195,0.03489518165588379,0.0,12543.379
187,16:47:00,0.4,1000,700,12,13,41,38,34,17,18,23,21,17,3320.3512884753072,13864.864,0.025557994842529297,0.01382899284362793,0.0,9135.136
196,16:23:30,0.4,1000,700,6,7,29,20,16,11,12,17,9,11,1954.0,8070.053999999999,0.03460192680358887,0.02420210838317871,0.0,8929.946
55,15:58:00,0.2,1000,700,4,5,72,54,33,26,30,42,28,26,4103.569792412309,16969.285,0.09035277366638184,0.20306992530822754,0.0,25030.715
187,16:47:00,0,1000,700,1,2,45,46,35,13,12,33,33,13,3315.972396206147,14823.722999999998,0.1448078155517578,1.6023170948028564,0.0,18176.277
155,07:44:30,0.4,1000,700,5,6,42,31,21,16,15,27,15,16,1926.0,8488.392999999998,0.03369498252868652,0.04813504219055176,0.0,18511.607000000004
192,14:50:30,1,1000,700,14,15,53,32,22,25,31,22,7,25,2090.0,8517.599,0.014086008071899414,0.0028128623962402344,0.0,13482.401
185,15:27:00,0.2,1000,700,3,4,25,24,19,9,9,16,15,9,2113.0,8946.947,0.012738943099975586,0.008423089981079102,0.0,7053.053
196,09:57:30,0.2,1000,700,3,4,15,17,16,5,5,10,12,5,2020.0,7807.444000000001,0.005242824554443359,0.008859872817993164,0.0,2192.5559999999987
199,13:24:30,0.2,1000,700,4,5,26,29,19,15,13,13,14,15,2990.0,11937.625,0.016380786895751953,0.018344879150390625,0.0,1062.375
193,13:30:30,0.2,1000,700,3,4,48,31,18,17,34,14,14,17,1565.0,6855.272000000001,0.05548095703125,0.013979911804199219,0.0,7144.727999999999
187,16:47:00,1,1000,700,29,30,46,25,34,21,30,16,4,21,3294.0,12745.358,0.01070094108581543,0.001995086669921875,0.0,3254.642
155,13:50:00,0.2,1000,700,3,4,31,28,16,16,14,17,12,16,1646.0,6727.739000000001,0.02146625518798828,0.01816105842590332,0.0,10272.260999999999
193,08:16:30,1,1000,700,13,14,44,24,14,24,32,12,0,24,1472.0,5418.034000000001,0.009212970733642578,0.0011930465698242188,0.0,6581.965999999999
193,13:30:30,1,1000,700,14,15,48,22,17,20,38,10,2,20,1589.0,6152.229000000001,0.009298086166381836,0.0012700557708740234,0.0,3847.770999999999
192,08:28:00,1,1000,700,12,13,34,23,19,17,20,14,6,17,1966.275724767358,7822.189000000001,0.006735086441040039,0.0026128292083740234,0.0,6177.810999999999
194,07:10:00,0,1000,700,1,2,51,34,24,12,19,32,22,12,2372.0,10409.991,0.09054327011108398,0.4068450927734375,0.0,21590.009
196,16:23:30,1,1000,700,14,15,27,15,18,12,20,7,3,12,1954.0,7508.771000000001,0.00518798828125,0.0011501312255859375,0.0,-508.77100000000064
195,07:09:00,0.2,1000,700,4,5,50,42,27,20,25,25,22,20,2514.0,10795.076999999997,0.05745983123779297,0.15285897254943848,0.0,14204.922999999992
199,16:04:00,0,1000,700,1,2,43,33,25,10,14,29,23,10,3069.0,13697.976999999999,0.07221508026123047,0.20427703857421875,0.0,15302.023510617044
155,13:50:00,0,1000,700,1,2,30,27,13,16,15,15,11,16,1646.0,7322.377999999999,0.03743696212768555,0.20950984954833984,0.0,7677.622000000001
55,18:56:00,0.2,1000,700,5,6,56,48,44,10,11,45,38,10,5139.0,22700.964000000004,0.12159085273742676,0.1039118766784668,0.0,22299.035999999996
199,16:04:00,0.4,1000,700,8,9,39,29,26,12,15,24,17,12,3069.0,13079.668,0.022711992263793945,0.01868605613708496,0.0,10920.332
191,07:22:00,0.2,1000,700,2,3,34,23,15,11,13,21,12,11,1358.0,5842.485734896091,0.01666998863220215,0.03858494758605957,0.0,15157.51426510391
193,08:16:30,0,1000,700,1,2,43,32,15,19,24,19,13,19,1472.0,6456.620999999999,0.06813216209411621,0.0827939510345459,0.0,12543.379
192,08:28:00,0,1000,700,1,2,34,32,20,14,15,19,18,14,1991.0,8440.062,0.05491805076599121,0.15611004829406738,0.0,10559.937999999996
196,16:23:30,0,1000,700,1,2,28,21,19,4,4,24,17,4,2060.0,9143.472,0.020617961883544922,0.3648960590362549,0.0,14856.528
185,07:21:00,1,1000,700,28,29,88,43,32,40,68,20,3,40,3435.0,13285.144000000002,0.02818894386291504,0.002149820327758789,0.0,6714.855999999998
192,14:50:30,0.2,1000,700,3,4,53,38,22,20,28,25,18,20,2118.0,9095.5,0.05271100997924805,0.14655399322509766,0.0,15904.5
196,09:57:30,1,1000,700,14,15,15,8,17,6,9,6,2,6,1956.0,8015.946,0.0020020008087158203,0.0008780956268310547,0.0,-2015.946
194,07:10:00,1,1000,700,22,23,51,23,25,21,37,14,2,21,2372.0,8928.65,0.01055002212524414,0.0014181137084960938,0.0,5071.35
187,13:47:00,0.2,1000,700,6,7,41,42,33,16,19,22,26,16,3338.0,13816.907,0.03651905059814453,0.03613615036010742,0.0,8183.093000000001
199,16:04:00,1,1000,700,19,20,43,18,25,13,19,24,5,13,3025.0,12363.740999999998,0.007605075836181641,0.003271818161010742,0.0,11636.259000000002
155,13:50:00,1,1000,700,14,15,31,20,17,18,20,11,2,18,1607.0,6196.468000000001,0.005815744400024414,0.0010988712310791016,0.0,4803.531999999999
199,13:24:30,0,1000,700,1,2,26,31,25,8,7,19,23,8,3030.0,13520.887999999997,0.04182696342468262,0.026827096939086914,0.0,5479.112000000003
195,07:09:00,1,1000,700,22,23,48,24,26,21,34,14,3,21,2459.528901216894,9635.070999999998,0.0110321044921875,0.0019059181213378906,0.0,4364.929000000002
196,09:57:30,0.4,1000,700,6,7,15,15,18,4,6,9,11,4,1956.0,8197.720000000001,0.003114938735961914,0.001528024673461914,0.0,802.2799999999988
185,15:27:00,0.4,1000,700,7,8,27,21,17,12,15,12,9,12,2159.0,8376.784000000001,0.009000301361083984,0.005029916763305664,0.0,3623.2159999999985
55,15:58:00,0,1000,700,1,2,72,61,46,17,19,53,44,17,4074.0,18176.131999999998,0.3902902603149414,1.1216979026794434,0.0,34823.868
198,19:44:00,0,1000,700,1,2,23,17,10,9,9,14,8,9,946.0,4139.721,0.011806011199951172,0.012656927108764648,0.0,9860.279
155,07:44:30,0.2,1000,700,2,3,45,33,19,17,20,25,16,17,1926.0,8477.269,0.06958293914794922,0.03287816047668457,0.0,16522.731
195,07:09:00,0,1000,700,1,2,50,45,30,17,15,35,28,17,2514.0,10895.59,0.15435433387756348,0.24135804176330566,0.0,24104.41
194,07:10:00,0.2,1000,700,4,5,52,29,22,12,15,37,17,12,2372.0,10391.051,0.029584884643554688,0.06853508949279785,0.0,26608.948999999997
55,15:58:00,0.4,1000,700,9,10,71,50,28,32,48,23,18,32,4126.0,13052.034825117442,0.06466412544250488,0.0385899543762207,0.0,9947.96611268328
195,13:21:00,0.2,1000,700,4,5,42,40,26,19,18,24,21,19,2468.0,10795.046999999999,0.04146003723144531,0.12413692474365234,0.0,13204.953000000001
192,08:28:00,0.2,1000,700,2,3,34,31,17,17,16,18,14,17,1991.0,8806.863000000001,0.029727935791015625,0.11719584465026855,0.0,9193.136999999999
193,08:16:30,0.4,1000,700,5,6,44,31,15,22,27,17,9,22,1466.5197745168225,6077.478000000001,0.02788710594177246,0.0473330020904541,0.0,10922.521999999999
198,19:44:00,1,1000,700,7,8,24,10,9,9,17,7,1,9,946.0,3464.248,0.002179861068725586,0.0010950565338134766,0.0,3535.752
196,16:23:30,0.2,1000,700,3,4,29,19,15,8,14,15,11,8,2060.0,6660.004,0.008953094482421875,0.012599945068359375,0.0,8339.996
192,08:28:00,0.2,1000,700,2,3,34,32,19,16,15,19,16,16,1991.0,8580.462358761322,0.03793191909790039,0.03350996971130371,0.0,10419.538984300358
193,08:16:30,0.4,1000,700,5,6,43,28,14,20,28,15,8,20,1444.0,5921.581,0.017473220825195312,0.0055561065673828125,0.0,9078.419
198,19:44:00,1,1000,700,7,8,23,11,9,10,15,8,1,10,946.0,3464.248,0.0024979114532470703,0.0013649463653564453,0.0,4535.752
55,15:58:00,1,1000,700,22,23,72,44,30,37,54,18,7,37,4126.0,15840.858,0.03384804725646973,0.003233194351196289,0.0,2159.142
196,16:23:30,0.2,1000,700,3,4,29,22,17,9,11,18,13,9,1954.0,8481.369999999999,0.011216878890991211,0.08874106407165527,0.0,9518.630000000001
187,16:47:00,0.2,1000,700,6,7,41,42,32,17,17,24,25,17,3338.0,13820.499999999998,0.032649993896484375,0.054574012756347656,0.0,10179.500000000002
55,15:58:00,0.4,1000,700,9,10,72,49,29,30,37,35,19,30,4126.0,13464.819999999998,0.05952811241149902,0.027425050735473633,0.0,21535.18
155,07:44:30,0.2,1000,700,2,3,42,34,22,15,14,28,19,15,1926.0,8504.104,0.06804561614990234,0.08162808418273926,0.0,19495.896
195,07:09:00,0,1000,700,1,2,48,38,27,13,15,33,25,13,2514.0,10919.939,0.10582923889160156,0.23528814315795898,0.0,22080.061
199,13:24:30,1,1000,700,19,20,26,19,23,16,18,8,3,16,2990.0,11622.539,0.005695343017578125,0.0014472007751464844,0.0,-3622.5390000000007
185,15:27:00,0.4,1000,700,7,8,25,21,19,10,11,14,11,10,2159.0,8447.997000000003,0.0068149566650390625,0.00421595573425293,0.0,5552.002999999997
198,19:44:00,0,1000,700,1,2,24,15,11,6,9,15,9,6,946.0,4127.227999999999,0.009911775588989258,0.007177114486694336,0.0,10872.772
196,09:57:30,0.4,1000,700,6,7,15,16,16,7,8,7,9,7,1965.163922691485,7473.059,0.0033359527587890625,0.0032820701599121094,0.0,-473.0590000000002
199,13:24:30,0.4,1000,700,8,9,26,26,21,14,13,13,12,14,2990.0,11937.624999999998,0.014505147933959961,0.008667945861816406,0.0,1062.3750000000018
193,13:30:30,0.4,1000,700,6,7,48,28,15,20,35,13,8,20,1565.0,6615.218000000001,0.020485877990722656,0.007475852966308594,0.0,6384.781999999999
195,07:09:00,1,1000,700,22,23,50,28,26,25,36,14,3,25,2506.0191481746588,9708.886999999999,0.015804290771484375,0.0025980472564697266,0.0,4291.113000000001
187,13:47:00,0.2,1000,700,6,7,40,36,25,18,20,20,18,18,3338.0,12853.676000000003,0.027099132537841797,0.020465850830078125,0.0,7146.323999999997
199,16:04:00,1,1000,700,19,20,43,18,24,14,24,19,4,14,3025.0,12511.964999999998,0.007850170135498047,0.0023729801177978516,0.0,6488.035000000002
155,13:50:00,1,1000,700,14,15,30,21,18,18,24,6,3,18,1607.0,6419.432000000001,0.0052983760833740234,0.0013129711151123047,0.0,-419.4320000000007
196,16:23:30,0,1000,700,1,2,27,23,20,5,6,21,18,5,2060.0,9004.856999999996,0.024590015411376953,1.7016539573669434,0.0,11995.143000000004
191,13:41:30,0.2,1000,700,3,4,22,22,15,11,10,12,11,11,1422.0,6120.224684128705,0.013881206512451172,0.013700008392333984,0.0,5879.775315871295
192,14:50:30,0.2,1000,700,3,4,53,40,23,21,24,29,19,21,2118.0,9230.233999999999,0.0567011833190918,0.11446309089660645,0.0,19769.766000000003
194,07:10:00,1,1000,700,22,23,51,18,24,17,31,20,1,17,2334.0,8928.65,0.008592844009399414,0.00102996826171875,0.0,11071.35
192,08:28:00,0,1000,700,1,2,34,33,19,16,14,20,17,16,1991.0,8620.317000000001,0.058705806732177734,0.1406240463256836,0.0,11379.682999999999
185,07:21:00,0.4,1000,700,11,12,88,56,37,31,48,40,25,31,3527.0,15011.638000000004,0.0968160629272461,0.11256289482116699,0.0,24988.361999999994
193,13:30:30,0,1000,700,1,2,48,33,19,16,19,29,17,16,1565.0,6958.243000000001,0.0815279483795166,0.019526004791259766,0.0,22041.756999999998
193,08:16:30,0,1000,700,1,2,44,35,17,20,23,21,15,20,1472.0,6485.9400000000005,0.0818638801574707,0.03650403022766113,0.0,14514.06
199,16:04:00,0,1000,700,1,2,43,32,26,8,11,32,24,8,3026.335369327411,13528.929635041233,0.06950616836547852,0.05917620658874512,0.0,18471.07116736917
155,13:50:00,0,1000,700,1,2,31,30,19,13,12,19,17,13,1646.0,6972.752,0.04584693908691406,0.059339046478271484,0.0,12027.248
55,18:56:00,0.2,1000,700,5,6,58,48,44,10,11,47,38,10,5139.0,22730.953000000005,0.11877202987670898,0.6239819526672363,0.0,24269.046999999995
196,09:57:30,0,1000,700,1,2,15,13,15,0,0,15,13,0,1956.0,8730.675,0.005450010299682617,0.056182861328125,0.0,6269.325000000001
194,07:10:00,0,1000,700,1,2,51,37,23,16,15,36,21,16,2372.0,10365.898000000001,0.10428595542907715,0.24959588050842285,0.0,25634.102
196,16:23:30,1,1000,700,14,15,28,13,16,12,20,8,1,12,2060.0,7461.303,0.004019021987915039,0.0009479522705078125,0.0,538.6970000000001
195,07:09:00,0.2,1000,700,4,5,48,35,25,15,22,26,20,15,2514.0,10751.147999999986,0.04272794723510742,0.18672919273376465,0.0,15248.851999999975
185,07:21:00,0,1000,700,1,2,88,64,35,31,37,51,33,31,3527.0,15735.739000000001,0.519406795501709,0.414031982421875,0.0,35264.261
192,08:28:00,1,1000,700,12,13,34,21,16,18,22,12,3,18,1966.275724767358,7625.888,0.005980253219604492,0.0015060901641845703,0.0,4374.112
155,13:50:00,0.2,1000,700,3,4,30,25,13,16,18,12,9,16,1646.0,6943.468000000001,0.01652383804321289,0.08037495613098145,0.0,5056.531999999999
193,08:16:30,1,1000,700,13,14,43,24,15,23,33,10,1,23,1472.0,5418.034000000001,0.00824284553527832,0.0009770393371582031,0.0,4581.965999999999
192,14:50:30,0,1000,700,1,2,53,41,22,21,19,34,20,21,2090.0,9298.002999999999,0.13443922996520996,0.265578031539917,0.0,24701.997000000003
187,16:47:00,1,1000,700,29,30,45,25,35,20,27,18,5,20,3294.0,12796.253,0.009582996368408203,0.0015480518341064453,0.0,5203.746999999999
196,09:57:30,0.2,1000,700,3,4,15,16,17,3,4,11,13,3,2020.0,8184.095,0.0037949085235595703,0.008210897445678711,0.0,2815.9049999999997
185,15:27:00,0.2,1000,700,3,4,27,23,16,11,11,16,12,11,2159.0,8431.911999999998,0.01371908187866211,0.034060001373291016,0.0,7568.088000000002
155,07:44:30,0.4,1000,700,5,6,45,30,17,19,25,20,11,19,1926.0,8149.008000000002,0.036351919174194336,0.018915891647338867,0.0,11850.991999999998
55,15:58:00,0.2,1000,700,4,5,71,53,34,24,32,39,29,24,4126.0,15916.992,0.08675193786621094,0.06592988967895508,0.0,23083.008
194,07:10:00,0.4,1000,700,9,10,52,26,24,12,15,37,14,12,2372.0,10391.050999999996,0.02430582046508789,0.0075931549072265625,0.0,26608.949000000004
187,16:47:00,0,1000,700,1,2,46,45,33,14,15,31,31,14,3303.2252147458785,14766.738,0.14264893531799316,0.7488818168640137,0.0,16233.262
195,13:21:00,0.4,1000,700,9,10,42,36,27,19,21,21,17,19,2468.0,10323.537,0.023888826370239258,0.06907916069030762,0.0,10676.463
192,08:28:00,0.4,1000,700,5,6,34,28,19,15,17,17,13,15,1976.0695687186817,8763.085,0.014134883880615234,0.011432170867919922,0.0,8236.915
193,08:16:30,0.2,1000,700,2,3,44,34,17,20,23,21,14,20,1465.3740604867562,6485.9400000000005,0.055394887924194336,0.022917985916137695,0.0,14514.06
196,16:23:30,0.4,1000,700,6,7,29,16,16,7,14,15,9,7,1954.0,7688.973,0.005541801452636719,0.004075050354003906,0.0,7311.027
155,13:50:00,0.4,1000,700,6,7,31,26,17,16,14,17,10,16,1646.0,6765.628000000001,0.012851953506469727,0.007086038589477539,0.0,10234.372
55,18:56:00,1,1000,700,27,28,58,41,33,36,40,18,5,36,5139.0,19680.796000000002,0.023454904556274414,0.002953052520751953,0.0,-1680.796000000002
195,07:09:00,0.4,1000,700,9,10,50,37,24,23,32,18,14,23,2514.0,10481.054999999998,0.0255279541015625,0.018074989318847656,0.0,7518.9450000000015
55,18:56:00,0.4,1000,700,11,12,56,45,37,20,23,33,25,20,5139.0,21591.844999999994,0.046304941177368164,0.7899940013885498,0.0,11408.155000000006
199,16:04:00,0.2,1000,700,4,5,39,32,26,11,11,28,21,11,3069.0,13386.283,0.045176029205322266,0.0175018310546875,0.0,14613.717
191,07:22:00,0.4,1000,700,5,6,34,20,15,11,16,18,9,11,1358.0,5443.923734896091,0.009459972381591797,0.004154205322265625,0.0,12556.076265103908
55,18:56:00,0,1000,700,1,2,62,56,49,9,10,52,47,9,5138.999999999985,22916.509999999995,0.2850801944732666,0.3047959804534912,0.0,29083.490000000005
187,13:47:00,0,1000,700,1,2,37,39,30,11,9,28,28,11,3338.0,14467.927999999998,0.08668208122253418,0.369783878326416,0.0,13532.072000000002
192,14:50:30,0.4,1000,700,6,7,53,36,24,19,29,24,17,19,2118.0,9008.505000000001,0.02533102035522461,0.01313018798828125,0.0,14991.494999999999
187,13:47:00,0.4,1000,700,12,13,41,37,28,22,25,16,15,22,3338.0,12614.516,0.02287888526916504,0.01633596420288086,0.0,3385.4840000000004
193,08:16:30,1,1000,700,13,14,46,23,16,21,32,14,2,21,1444.0,5574.992,0.00933694839477539,0.0009381771087646484,0.0,8425.008
155,13:50:00,0.2,1000,700,3,4,32,25,18,11,15,17,14,11,1646.0,7144.071,0.018452882766723633,0.01990199089050293,0.0,9855.929
193,13:30:30,1,1000,700,14,15,48,27,16,26,37,11,1,26,1565.0,6152.229,0.010556936264038086,0.0011820793151855469,0.0,4847.771
192,08:28:00,1,1000,700,12,13,34,19,17,15,19,15,4,15,1966.275724767358,7880.0380000000005,0.00491023063659668,0.0011470317840576172,0.0,7119.9619999999995
194,07:10:00,0,1000,700,1,2,52,32,21,13,12,40,19,13,2372.0,10567.337,0.08239102363586426,0.3077881336212158,0.0,29432.663
196,09:57:30,0,1000,700,1,2,13,13,7,8,5,8,5,8,1956.0,4311.594,0.004815101623535156,0.016095876693725586,0.0,3688.406
185,07:21:00,0,1000,700,1,2,89,64,37,29,30,59,35,29,3527.0,15587.871000000001,0.5269279479980469,0.23504900932312012,0.0,43412.129
194,15:17:30,1,1000,700,22,23,48,17,25,15,25,23,2,15,2343.0,9042.614999999998,0.008085012435913086,0.0010859966278076172,0.0,13957.385000000002
198,19:44:00,0.2,1000,700,1,2,24,19,12,9,10,14,10,9,946.0,3878.4380000000006,0.01575922966003418,0.012403011322021484,0.0,10121.562
194,15:17:30,0.4,1000,700,9,10,50,27,20,17,24,26,10,17,2343.0,9350.587,0.012683868408203125,0.0028738975524902344,0.0,16649.413
185,15:27:00,0,1000,700,1,2,21,26,19,9,6,15,17,9,2159.0,9378.596,0.024814844131469727,0.015093803405761719,0.0,5621.404
193,13:30:30,0,1000,700,1,2,46,35,16,21,22,24,14,21,1565.0,6942.977000000002,0.08710622787475586,0.019771814346313477,0.0,17057.022999999997
185,07:21:00,0.4,1000,700,11,12,89,57,39,30,39,50,27,30,3527.0,15088.449999999997,0.09266304969787598,0.06450700759887695,0.0,34911.55
199,16:04:00,0.4,1000,700,8,9,42,31,30,10,15,27,21,10,3069.0,13062.398999999996,0.02581310272216797,0.008749008178710938,0.0,13937.601000000004
191,07:22:00,0.2,1000,700,2,3,33,28,16,15,17,16,13,15,1387.0,6119.13073489609,0.024285078048706055,0.05429792404174805,0.0,9880.86926510391
191,13:41:30,0.2,1000,700,3,4,21,19,17,6,10,11,13,6,1381.0,5863.838684128705,0.010355949401855469,0.004477977752685547,0.0,5136.161315871295
185,07:21:00,1,1000,700,28,29,90,43,34,38,54,36,5,38,3472.983491410163,14011.022,0.030743122100830078,0.002174854278564453,0.0,21988.978
196,16:23:30,0,1000,700,1,2,29,23,19,6,7,22,17,6,2060.0,8937.537999999999,0.026041030883789062,0.10189104080200195,0.0,13062.462000000001
194,15:17:30,0,1000,700,1,2,50,33,22,13,14,36,20,13,2343.0,10377.824999999999,0.08353114128112793,0.048876047134399414,0.0,25622.175000000003
196,09:57:30,1,1000,700,14,15,15,12,18,9,12,3,3,9,1956.0,7745.469,0.0026018619537353516,0.0009808540344238281,0.0,-4745.469
187,13:47:00,0.2,1000,700,6,7,37,37,31,13,16,21,24,13,3338.0,14172.316,0.02629232406616211,0.016819000244140625,0.0,6827.683999999999
185,15:27:00,1,1000,700,17,18,26,18,23,13,20,6,5,13,2113.0,8614.527999999998,0.004742860794067383,0.0008800029754638672,0.0,-2614.5279999999984
155,13:50:00,1,1000,700,14,15,32,17,17,15,18,14,2,15,1607.0,6196.468000000001,0.005424022674560547,0.0010559558868408203,0.0,7803.531999999999
199,13:24:30,0,1000,700,1,2,29,24,19,7,9,20,17,7,2990.0,13352.589358773166,0.027419328689575195,0.053774118423461914,0.0,6647.411370548425
198,10:24:30,0,1000,700,1,2,17,17,9,10,10,7,7,10,790.0,3510.5789999999997,0.009483098983764648,0.006771087646484375,0.0,3489.4210000000003
193,13:30:30,0.4,1000,700,6,7,46,30,15,22,32,14,8,22,1565.0,6710.254000000001,0.023608922958374023,0.013382911682128906,0.0,7289.745999999999
195,13:21:00,1,1000,700,22,23,41,27,29,21,25,16,6,21,2468.0,9746.443,0.009983301162719727,0.001828908920288086,0.0,6253.557000000001
199,13:24:30,0.4,1000,700,8,9,32,24,21,12,14,18,12,12,2990.0,12538.687,0.011384725570678711,0.005304098129272461,0.0,5461.313
191,07:22:00,1,1000,700,13,14,34,18,15,17,26,8,1,17,1387.0,5095.854734896091,0.00609898567199707,0.0006160736083984375,0.0,2904.145265103909
55,15:58:00,0,1000,700,1,2,71,55,45,12,12,59,43,12,4074.0,18098.385000000002,0.3118100166320801,0.1762678623199463,0.0,40901.615
198,10:24:30,1,1000,700,7,8,18,10,8,10,13,5,0,10,790.0,2855.712,0.001764059066772461,0.0005078315734863281,0.0,2144.288
199,13:24:30,1,1000,700,19,20,32,17,24,13,17,15,4,13,2990.0,12457.900999999998,0.004995107650756836,0.002382040023803711,0.0,2542.099000000002
194,07:10:00,0.2,1000,700,4,5,51,31,21,15,20,31,16,15,2372.0,10410.232999999995,0.02886199951171875,0.08667898178100586,0.0,20589.766999999985
191,07:22:00,0,1000,700,1,2,31,24,15,11,16,15,13,11,1387.0,6152.289734896126,0.02977299690246582,0.02301502227783203,0.0,8847.710265103718
195,13:21:00,0.2,1000,700,4,5,41,37,27,15,19,22,22,15,2468.0,10668.557,0.03641390800476074,0.0854949951171875,0.0,11331.443
198,10:24:30,0.2,1000,700,2,3,18,14,7,10,13,5,4,10,747.0,2855.7119999999995,0.004231929779052734,0.0031549930572509766,0.0,2144.2880000000005
195,13:21:00,0,1000,700,1,2,40,42,27,17,17,23,25,17,2556.0,11374.161000000002,0.10749626159667969,0.37541818618774414,0.0,11625.838999999998
193,08:16:30,0.4,1000,700,5,6,46,29,16,19,28,18,10,19,1472.0,5865.094,0.02400994300842285,0.02456808090209961,0.0,12134.905999999999
198,19:44:00,1,1000,700,7,8,24,12,10,10,15,9,2,10,918.0,3464.248,0.002977132797241211,0.001077890396118164,0.0,5535.752
187,16:47:00,0.2,1000,700,6,7,45,41,32,16,18,27,25,16,3338.0,14224.3,0.03223228454589844,0.021296977996826172,0.0,12775.7
55,15:58:00,1,1000,700,22,23,71,37,29,31,49,22,6,31,4119.865068002866,15748.749000000002,0.026504039764404297,0.002170085906982422,0.0,6251.250999999998
191,13:41:30,0.4,1000,700,6,7,22,14,11,10,11,11,4,10,1381.0,5520.9046841287045,0.004065036773681641,0.0017850399017333984,0.0,5479.0953158712955
187,13:47:00,0,1000,700,1,2,40,41,29,14,12,28,27,14,3294.0,14653.705000000045,0.10407209396362305,2.6003329753875732,0.0,13346.294999999984
199,16:04:00,0.2,1000,700,4,5,45,34,21,18,14,31,16,18,3069.0,13189.552000000001,0.05831480026245117,0.017206907272338867,0.0,17810.447999999997
185,07:21:00,0.2,1000,700,5,6,90,63,38,31,36,54,32,31,3527.0,15541.076000000003,0.19879984855651855,0.14476680755615234,0.0,38458.924
191,07:22:00,0.4,1000,700,5,6,31,22,18,10,9,22,12,10,1385.445493668598,5898.05273489609,0.007842779159545898,0.002753019332885742,0.0,16101.94726510391
194,15:17:30,0.2,1000,700,4,5,48,28,22,11,22,26,17,11,2356.8992931281246,10297.189999999999,0.02793121337890625,0.004442930221557617,0.0,15702.810000000001
198,19:44:00,0.4,1000,700,3,4,23,13,11,6,8,15,7,6,929.594890837514,3879.101,0.003820657730102539,0.004014015197753906,0.0,11120.899
187,13:47:00,1,1000,700,29,30,41,29,34,25,29,12,4,25,3294.0,12813.159,0.011358022689819336,0.0013339519500732422,0.0,-813.1589999999997
55,18:56:00,1,1000,700,27,28,59,37,31,34,41,18,3,34,5105.0,19362.765000000003,0.02024221420288086,0.002621889114379883,0.0,-1362.765000000003
192,08:28:00,0.4,1000,700,5,6,34,26,18,14,17,17,12,14,1976.0695687186817,8351.608,0.011391878128051758,0.008852005004882812,0.0,8648.392
187,16:47:00,0.4,1000,700,12,13,46,36,30,19,26,20,17,19,3294.0,13461.378999999997,0.024341106414794922,0.016408920288085938,0.0,6538.621000000003
191,13:41:30,0,1000,700,1,2,23,18,10,10,12,11,8,10,1422.0,6109.509684128704,0.013440132141113281,0.01032400131225586,0.0,4890.490315871296
198,10:24:30,0.4,1000,700,3,4,17,15,9,10,14,3,5,10,747.0,3225.6719999999996,0.004136323928833008,0.0015671253204345703,0.0,-225.67199999999957
195,13:21:00,0.4,1000,700,9,10,41,32,25,17,17,24,15,17,2468.0,9748.676,0.01843404769897461,0.0393369197845459,0.0,14251.324
194,07:10:00,0.4,1000,700,9,10,51,32,25,17,25,26,15,17,2372.0,10279.656999999956,0.03368186950683594,0.014726877212524414,0.0,15720.34299999999
155,07:44:30,1,1000,700,12,13,45,24,15,22,32,13,2,22,1868.0,7659.410000000001,0.008244991302490234,0.0012760162353515625,0.0,5340.589999999999
192,14:50:30,1,1000,700,14,15,53,31,19,27,38,15,4,27,2090.0,8134.388,0.015118122100830078,0.002285003662109375,0.0,6865.612
185,15:27:00,0.2,1000,700,3,4,26,26,20,10,11,15,16,10,2159.0,9339.22,0.015729904174804688,0.011277914047241211,0.0,5660.780000000001
191,13:41:30,1,1000,700,14,15,23,11,16,10,16,7,1,10,1422.0,5202.024684128705,0.002777099609375,0.00055694580078125,0.0,1797.9753158712947
199,13:24:30,0.2,1000,700,4,5,29,22,18,9,12,17,13,9,2990.0,13084.848999999998,0.009387969970703125,0.012071847915649414,0.0,3915.1510000000017
187,16:47:00,1,1000,700,29,30,41,26,37,19,20,21,7,19,3294.0,13071.392999999998,0.010738134384155273,0.0017800331115722656,0.0,7928.607000000002
193,13:30:30,0.2,1000,700,3,4,48,36,15,25,32,16,11,25,1565.0,6780.923259071149,0.07682299613952637,0.02349400520324707,0.0,9219.077815755882
192,14:50:30,0,1000,700,1,2,51,40,23,19,20,31,21,19,2090.0,9224.299,0.12419009208679199,0.3708639144897461,0.0,21775.701
155,07:44:30,0,1000,700,1,2,42,35,22,15,13,29,20,15,1926.0,8449.913236408644,0.07953572273254395,0.08994507789611816,0.0,20550.087511959173
192,14:50:30,0,1000,700,1,2,53,41,22,21,25,28,20,21,2118.0,9458.633,0.1332838535308838,0.707244873046875,0.0,18541.367
155,07:44:30,0,1000,700,1,2,45,34,21,15,16,29,19,15,1926.0,8514.778,0.08124303817749023,0.028870105743408203,0.0,20485.222
193,13:30:30,0.2,1000,700,3,4,46,33,15,22,31,15,11,22,1589.0,6825.194,0.058294057846069336,0.021873950958251953,0.0,8174.806
199,13:24:30,0.2,1000,700,4,5,32,25,18,12,14,18,13,12,2990.0,12486.202000000001,0.01253199577331543,0.006731986999511719,0.0,5513.797999999999
191,13:41:30,1,1000,700,14,15,23,11,15,11,18,5,0,11,1422.0,5202.024684128705,0.0028400421142578125,0.0005030632019042969,0.0,-202.0246841287053
155,07:44:30,1,1000,700,12,13,42,27,16,24,31,11,3,24,1868.0,8024.776000000001,0.009488344192504883,0.0014801025390625,0.0,2975.2239999999993
192,14:50:30,1,1000,700,14,15,51,29,20,24,30,21,5,24,2090.0,8727.952,0.011795997619628906,0.0018720626831054688,0.0,12272.048
194,07:10:00,0.4,1000,700,9,10,51,26,22,14,24,27,12,14,2372.0,9841.184,0.02217411994934082,0.028647899627685547,0.0,17158.816
187,16:47:00,0,1000,700,1,2,41,45,33,14,11,30,31,14,3338.0,14880.016,0.12664341926574707,0.6297011375427246,0.0,15119.984
198,10:24:30,0.4,1000,700,3,4,18,13,6,11,13,5,2,11,747.0,2855.7120000000004,0.003237009048461914,0.0015921592712402344,0.0,2144.2879999999996
195,13:21:00,0.4,1000,700,9,10,41,34,26,18,23,18,16,18,2468.0,9968.553000000002,0.02263617515563965,0.03365302085876465,0.0,8031.446999999998
193,08:16:30,0.2,1000,700,2,3,46,31,17,17,24,22,14,17,1472.0,6417.152,0.04324030876159668,0.016067028045654297,0.0,15582.848
191,13:41:30,0,1000,700,1,2,23,21,15,8,11,12,13,8,1422.0,6055.5476841287045,0.018095731735229492,0.016062021255493164,0.0,5944.4523158712955
187,16:47:00,0.4,1000,700,12,13,45,37,32,18,21,24,19,18,3338.0,13721.285,0.02370285987854004,0.015314817428588867,0.0,10278.715
155,13:50:00,0.4,1000,700,6,7,32,22,17,12,16,16,10,12,1646.0,6664.352,0.011169672012329102,0.007489919662475586,0.0,9335.648000000001
187,13:47:00,1,1000,700,29,30,40,25,33,22,29,11,3,22,3338.0,12603.902,0.010226011276245117,0.0010440349578857422,0.0,-1603.902
194,15:17:30,0.2,1000,700,4,5,50,30,19,16,23,27,14,16,2382.0,9721.01,0.029586076736450195,0.01711106300354004,0.0,17278.989999999998
198,19:44:00,0.4,1000,700,3,4,24,17,12,9,10,14,8,9,946.0,4140.563,0.005579948425292969,0.002855062484741211,0.0,9859.437
199,16:04:00,0.2,1000,700,4,5,42,32,28,9,13,29,23,9,3069.0,13069.948999999997,0.051564931869506836,0.02381110191345215,0.0,15930.051000000003
185,07:21:00,0.2,1000,700,5,6,89,61,39,28,35,54,33,28,3527.0,15327.758000000002,0.15104103088378906,0.32749199867248535,0.0,38672.242
191,07:22:00,0.4,1000,700,5,6,33,26,16,16,20,13,10,16,1387.0,5331.06073489609,0.011795282363891602,0.006267070770263672,0.0,7668.93926510391
55,18:56:00,0,1000,700,1,2,59,57,45,14,14,45,43,14,5139.0,22427.164545956213,0.28284192085266113,0.681096076965332,0.0,22572.836427955892
191,13:41:30,0.4,1000,700,6,7,21,16,15,8,11,10,8,8,1381.0,5520.904684128705,0.004675149917602539,0.0016620159149169922,0.0,4479.095315871295
187,13:47:00,0,1000,700,1,2,41,47,34,15,12,29,32,15,3338.0,14919.489286854907,0.13872170448303223,115.66089701652527,0.0,14080.51149345397
187,13:47:00,0.4,1000,700,12,13,37,33,32,14,17,20,19,14,3334.7032480314956,13900.995,0.023991107940673828,0.009176969528198242,0.0,6099.004999999999
192,08:28:00,0.2,1000,700,2,3,34,29,17,15,16,18,14,15,1991.0,8631.702000000001,0.03248310089111328,0.07000112533569336,0.0,9368.297999999999
187,16:47:00,0.2,1000,700,6,7,46,41,35,13,20,26,28,13,3338.0,14563.190999999997,0.03634810447692871,0.05066108703613281,0.0,11436.809000000003
55,15:58:00,1,1000,700,22,23,71,37,31,29,47,24,8,29,4119.865068002866,16078.588,0.027675867080688477,0.003155946731567383,0.0,7921.412
191,07:22:00,0,1000,700,1,2,34,27,13,16,17,17,11,16,1358.0,5954.862734896091,0.04457974433898926,0.04784417152404785,0.0,11045.13726510391
195,13:21:00,0.2,1000,700,4,5,41,36,27,14,12,29,22,14,2468.0,10896.8381881265,0.040411949157714844,0.02896714210510254,0.0,18103.16222873899
198,10:24:30,0.2,1000,700,2,3,17,16,9,10,14,3,6,10,747.0,3225.672,0.005160331726074219,0.0047070980072021484,0.0,-225.6719999999782
195,13:21:00,0,1000,700,1,2,41,43,30,15,11,30,28,15,2556.0,11235.98919035338,0.12046313285827637,0.09512996673583984,0.0,18764.01161080395
194,07:10:00,0.2,1000,700,4,5,51,34,22,17,17,34,17,17,2372.0,10129.956999999997,0.04027295112609863,0.18575096130371094,0.0,23870.043000000005
198,10:24:30,1,1000,700,7,8,17,12,9,11,15,2,1,11,790.0,2855.7120000000004,0.0020427703857421875,0.001146078109741211,0.0,-855.7120000000004
199,13:24:30,1,1000,700,19,20,29,14,23,11,19,10,3,11,2990.0,12189.558999999997,0.003988981246948242,0.002111196517944336,0.0,-2189.5589999999975
55,15:58:00,0,1000,700,1,2,71,53,43,12,14,57,41,12,4126.0,18139.003,0.3025660514831543,0.26875805854797363,0.0,38860.997
185,15:27:00,0.4,1000,700,7,8,26,23,20,11,14,12,12,11,2159.0,8760.107999999998,0.008965015411376953,0.005394935607910156,0.0,3239.8920000000016
198,19:44:00,0,1000,700,1,2,24,17,10,9,9,15,8,9,918.0,4050.719,0.012220144271850586,0.013068914413452148,0.0,10949.280999999999
195,13:21:00,1,1000,700,22,23,40,27,26,24,30,10,3,24,2468.0,9746.443,0.010272741317749023,0.002808809280395508,0.0,253.5570000000007
199,13:24:30,0.4,1000,700,8,9,29,20,20,9,14,15,11,9,3030.0,12723.067381115787,0.00900411605834961,0.015227079391479492,0.0,2276.933582519395
191,07:22:00,1,1000,700,13,14,31,14,16,12,22,9,2,12,1387.0,5095.854734896091,0.003860950469970703,0.0006260871887207031,0.0,3904.145265103909
193,13:30:30,0.4,1000,700,6,7,48,33,15,25,32,16,8,25,1569.2321045096687,6780.923,0.02699589729309082,0.00960397720336914,0.0,9219.077000000001
199,13:24:30,0,1000,700,1,2,32,27,21,8,9,23,19,8,2993.471725125266,13382.016000000001,0.03744626045227051,0.014647960662841797,0.0,9617.983999999999
198,10:24:30,0,1000,700,1,2,18,15,8,9,12,6,6,9,747.0,3268.3279999999995,0.00775909423828125,0.015882015228271484,0.0,2731.6720000000005
185,15:27:00,1,1000,700,17,18,21,13,19,12,15,6,1,12,2113.0,8163.151,0.002680063247680664,0.0009300708770751953,0.0,-2163.151
191,13:41:30,0.2,1000,700,3,4,22,17,11,10,11,11,7,10,1381.0,5520.9046841287045,0.007075071334838867,0.0062408447265625,0.0,5479.0953158712955
185,07:21:00,1,1000,700,28,29,89,42,36,35,58,31,7,35,3472.983491410163,14272.117,0.0295259952545166,0.0025081634521484375,0.0,16727.883
194,15:17:30,0,1000,700,1,2,48,31,24,9,14,34,22,9,2381.9999999999927,10639.332000000002,0.07221603393554688,0.05467391014099121,0.0,23360.667999999998
194,07:10:00,1,1000,700,22,23,52,19,25,17,34,18,2,17,2372.0,8741.315,0.008796930313110352,0.0014500617980957031,0.0,9258.685
196,09:57:30,1,1000,700,14,15,13,7,16,6,10,3,1,6,1956.0,7688.546999999999,0.0014679431915283203,0.0010399818420410156,0.0,-4688.546999999999
192,08:28:00,0,1000,700,1,2,34,30,19,13,14,20,17,13,1991.0,8877.09,0.04889273643493652,0.16406989097595215,0.0,11122.91
193,13:30:30,0,1000,700,1,2,48,38,16,24,29,19,14,24,1589.0,7091.937999999999,0.10703277587890625,0.03808879852294922,0.0,11908.062000000002
185,07:21:00,0.4,1000,700,11,12,90,57,36,33,42,48,24,33,3527.0,15042.61,0.10108613967895508,0.10784912109375,0.0,32957.39
199,16:04:00,0.4,1000,700,8,9,45,31,24,16,15,30,15,16,3025.0,13035.57107345889,0.0292360782623291,0.019870996475219727,0.0,16964.42902173787
191,07:22:00,0.2,1000,700,2,3,31,24,17,10,8,23,14,10,1358.0,5757.66873489609,0.017931222915649414,0.00978994369506836,0.0,17242.33126510391
193,08:16:30,0,1000,700,1,2,46,32,17,17,24,22,15,17,1472.0,6417.152,0.07464814186096191,0.02953505516052246,0.0,15582.848
155,13:50:00,0,1000,700,1,2,32,27,18,11,11,21,16,11,1646.0,7085.537271953542,0.03790903091430664,0.016017913818359375,0.0,13914.463682460904
198,19:44:00,0.2,1000,700,1,2,23,15,11,6,7,16,9,6,946.0,3955.6100000000006,0.009418010711669922,0.008489131927490234,0.0,12044.39
194,15:17:30,0.4,1000,700,9,10,48,25,22,13,24,24,12,13,2343.0,9398.907,0.011041641235351562,0.004759073257446289,0.0,14601.093
185,15:27:00,0,1000,700,1,2,26,29,19,12,11,15,17,12,2159.0,9285.613440251229,0.0402066707611084,0.05617785453796387,0.0,5714.3876804485735
196,09:57:30,0,1000,700,1,2,15,18,16,4,3,12,14,4,2020.0,8807.440999999997,0.009477853775024414,0.11517095565795898,0.0,3192.559000000003
185,07:21:00,0,1000,700,1,2,90,67,39,30,34,56,37,30,3527.0,15606.935,0.6039109230041504,0.608238935470581,0.0,40393.065
194,15:17:30,1,1000,700,22,23,50,20,25,18,26,24,2,18,2343.0,9042.614999999998,0.008936882019042969,0.0014920234680175781,0.0,14957.385000000002
196,16:23:30,1,1000,700,14,15,29,14,15,14,23,6,0,14,2060.0,7461.303,0.003954887390136719,0.0018291473388671875,0.0,-1461.3029999999999
193,13:30:30,1,1000,700,14,15,46,25,16,24,38,8,1,24,1589.0,5866.755000000001,0.008831024169921875,0.001383066177368164,0.0,2133.244999999999
187,16:47:00,0.2,1000,700,6,7,45,41,32,16,14,31,25,16,3338.0,14183.023999999998,0.03215599060058594,0.03201103210449219,0.0,16816.976000000002
55,15:58:00,1,1000,700,22,23,72,39,27,35,49,23,4,35,4074.0,15882.152000000004,0.02781963348388672,0.0023980140686035156,0.0,7117.847999999996
195,13:21:00,0,1000,700,1,2,41,39,28,13,13,28,26,13,2556.0,11280.968000000004,0.09494400024414062,0.3189718723297119,0.0,16719.031999999996
198,10:24:30,0.2,1000,700,2,3,17,15,7,11,13,4,4,11,747.0,2855.7120000000004,0.004339933395385742,0.005789995193481445,0.0,1144.2879999999996
195,13:21:00,0.2,1000,700,4,5,40,40,23,22,21,19,18,22,2468.0,10616.565999999999,0.04396986961364746,0.18443894386291504,0.0,8383.434000000001
191,07:22:00,0,1000,700,1,2,33,29,15,16,15,18,13,16,1358.0,5941.667734896091,0.04471135139465332,0.05748796463012695,0.0,12058.33301510391
194,07:10:00,0.2,1000,700,4,5,51,33,24,14,15,36,19,14,2369.1220472440946,10220.586,0.03530287742614746,0.06728315353393555,0.0,25779.414
55,15:58:00,0.4,1000,700,9,10,72,54,32,32,47,25,22,32,4126.0,13694.987000000003,0.07328104972839355,0.05515789985656738,0.0,11305.012999999997
199,13:24:30,1,1000,700,19,20,30,14,23,11,14,16,3,11,2990.0,12068.534,0.00429081916809082,0.0011398792266845703,0.0,3931.4660000000003
155,07:44:30,0.2,1000,700,2,3,45,31,23,11,15,30,20,11,1926.0,8558.021149998343,0.05959606170654297,0.12355804443359375,0.0,21441.97928020065
198,10:24:30,1,1000,700,7,8,17,11,9,10,13,4,1,10,790.0,2855.7120000000004,0.0018351078033447266,0.0006251335144042969,0.0,1144.2879999999996
55,15:58:00,0,1000,700,1,2,71,56,45,13,15,56,43,13,4074.0,18159.206,0.32395505905151367,0.17039704322814941,0.0,37840.794
199,13:24:30,0.4,1000,700,8,9,30,21,21,9,11,19,12,9,2990.0,12188.251999999997,0.00832223892211914,0.0032210350036621094,0.0,6811.748000000003
191,07:22:00,1,1000,700,13,14,31,14,17,11,12,19,3,11,1387.0,5095.854734896091,0.004022121429443359,0.0007841587066650391,0.0,13904.145265103909
195,13:21:00,1,1000,700,22,23,41,23,26,20,21,20,3,20,2556.0,9530.940999999999,0.007462739944458008,0.0011811256408691406,0.0,10469.059000000001
196,09:57:30,0.4,1000,700,6,7,15,11,16,2,2,13,9,2,1956.0,8454.194,0.0017740726470947266,0.0012369155883789062,0.0,4545.8060000000005
193,13:30:30,0.4,1000,700,6,7,48,36,16,27,32,16,9,27,1565.0,6552.657999999999,0.0328369140625,0.014373779296875,0.0,9447.342
198,10:24:30,0,1000,700,1,2,19,15,10,7,10,9,8,7,790.0,3270.5649999999996,0.008404970169067383,0.009502887725830078,0.0,5729.435
195,07:09:00,1,1000,700,22,23,50,29,28,24,31,19,5,24,2514.0,9501.056999999999,0.013477802276611328,0.0019528865814208984,0.0,9498.943000000001
199,13:24:30,0,1000,700,1,2,30,33,25,10,9,21,23,10,3030.0,13456.511999999999,0.05211281776428223,0.09852409362792969,0.0,7543.488000000001
185,15:27:00,1,1000,700,17,18,25,17,23,12,13,12,5,12,2113.0,8251.109,0.003898143768310547,0.0009381771087646484,0.0,3748.8909999999996
192,14:50:30,0.2,1000,700,3,4,53,39,22,21,21,32,18,21,2118.0,8940.846,0.049103736877441406,0.06928300857543945,0.0,23059.154000000002
196,09:57:30,1,1000,700,14,15,15,10,18,7,10,5,3,7,1956.0,7688.5470000000005,0.0022802352905273438,0.0008440017700195312,0.0,-2688.5470000000005
194,15:17:30,0,1000,700,1,2,49,36,25,13,18,31,23,13,2382.0,10594.532,0.09702205657958984,0.09153103828430176,0.0,20405.468
191,13:41:30,0.2,1000,700,3,4,23,20,16,8,12,11,12,8,1422.0,5878.744684128705,0.011828899383544922,0.005254030227661133,0.0,5121.255315871295
185,07:21:00,1,1000,700,28,29,89,35,33,31,51,38,4,31,3435.0,13574.43,0.0220639705657959,0.0018069744110107422,0.0,24425.57
191,07:22:00,0.2,1000,700,2,3,31,24,16,11,19,12,13,11,1358.0,5757.66873489609,0.01721501350402832,0.04637408256530762,0.0,6242.33126510391
199,16:04:00,0.4,1000,700,8,9,43,27,24,12,19,24,15,12,3025.0,12900.686,0.023248672485351562,0.058717966079711914,0.0,11099.314
193,13:30:30,0,1000,700,1,2,48,40,19,23,26,22,17,23,1567.8364352183198,7008.856,0.11704802513122559,0.07126688957214355,0.0,14991.144
185,07:21:00,0.4,1000,700,11,12,87,52,36,28,37,50,24,28,3527.0,15219.624,0.07230591773986816,0.040947914123535156,0.0,34780.376000000004
194,15:17:30,0.4,1000,700,9,10,49,29,24,15,29,20,14,15,2382.0,9878.609,0.013750791549682617,0.004890918731689453,0.0,10121.391
185,15:27:00,0,1000,700,1,2,27,25,20,7,7,20,18,7,2159.0,9508.68,0.027657032012939453,0.028448820114135742,0.0,10491.32
198,19:44:00,0.2,1000,700,1,2,23,17,10,9,9,14,8,9,946.0,4139.721,0.011776208877563477,0.011951923370361328,0.0,9860.279
199,16:04:00,0,1000,700,1,2,39,35,28,9,10,29,26,9,3069.0,13386.283,0.0738978385925293,0.05045008659362793,0.0,15613.717
194,15:17:30,1,1000,700,22,23,49,20,26,17,34,15,3,17,2343.0,9042.614999999998,0.008821964263916016,0.0009920597076416016,0.0,5957.385000000002
185,07:21:00,0,1000,700,1,2,87,61,38,25,32,55,36,25,3527.0,15610.82910830019,0.47333788871765137,0.3784360885620117,8.314235590938208e-12,39389.17157595733
196,09:57:30,0,1000,700,1,2,15,18,18,2,1,14,16,2,2008.0366410164643,8976.726999999999,0.010235071182250977,0.03828287124633789,0.0,5023.273000000001
193,13:30:30,1,1000,700,14,15,48,22,16,21,34,14,1,21,1565.0,6125.9890000000005,0.010902166366577148,0.001497030258178711,0.0,7874.0109999999995
155,07:44:30,0,1000,700,1,2,46,37,23,16,21,25,21,16,1926.0,8256.741063107334,0.09747791290283203,0.2331249713897705,0.0,16743.2591133596
192,14:50:30,0,1000,700,1,2,53,42,23,21,22,31,21,21,2118.0,9456.926,0.1409900188446045,0.20238399505615234,0.0,21543.074
193,13:30:30,0.2,1000,700,3,4,48,30,16,18,29,19,12,18,1589.0,7001.405000000022,0.05321073532104492,0.03193306922912598,0.0,11998.594999999976
199,13:24:30,0.2,1000,700,4,5,30,30,20,15,17,13,15,15,2990.0,11984.777999999998,0.014139890670776367,0.014602899551391602,0.0,1015.2220000000016
191,13:41:30,1,1000,700,14,15,21,10,17,8,15,6,2,8,1422.0,5202.024684128705,0.0025300979614257812,0.000576019287109375,0.0,797.9753158712947
192,14:50:30,1,1000,700,14,15,53,30,22,23,38,15,7,23,2090.0,8393.471,0.013715982437133789,0.0027170181274414062,0.0,6606.529
155,07:44:30,1,1000,700,12,13,46,25,16,22,33,13,3,22,1868.0,7310.202000000002,0.008786916732788086,0.0013151168823242188,0.0,5689.797999999998
194,07:10:00,0.4,1000,700,9,10,52,24,23,11,23,29,13,11,2372.0,10240.091999999999,0.018177032470703125,0.06032919883728027,0.0,18759.908000000003
195,13:21:00,0.4,1000,700,9,10,41,37,27,20,20,21,17,20,2468.0,9830.64,0.026279926300048828,0.026010990142822266,0.0,11169.36
198,10:24:30,0.4,1000,700,3,4,19,13,9,8,15,4,5,8,747.0,3162.2749999999996,0.0031931400299072266,0.0022721290588378906,0.0,837.7250000000004
196,16:23:30,0.4,1000,700,6,7,29,21,16,12,17,12,9,12,1984.409583035078,7358.89,0.010202169418334961,0.008955001831054688,0.0,4641.11
191,13:41:30,0,1000,700,1,2,22,19,12,9,10,12,10,9,1381.0,6040.641684128705,0.013826847076416016,0.019776105880737305,0.0,5959.358315871295
187,16:47:00,0.4,1000,700,12,13,43,44,35,22,21,22,22,22,3299.4557981388716,14354.793,0.033605098724365234,0.02572178840637207,0.0,7645.207
187,13:47:00,1,1000,700,29,30,38,27,35,22,21,17,5,22,3294.0,12707.103000000003,0.009712934494018555,0.0012450218200683594,0.0,4292.896999999997
195,07:09:00,0.4,1000,700,9,10,50,36,25,21,27,23,15,21,2447.0,10340.395,0.02785468101501465,0.01721501350402832,0.0,12659.605
198,19:44:00,0.4,1000,700,3,4,24,13,10,7,11,13,6,7,929.594890837514,4050.719,0.004604816436767578,0.005851030349731445,0.0,8949.280999999999
55,18:56:00,0.4,1000,700,11,12,59,48,35,25,26,33,23,25,5105.0,21943.945,0.06018400192260742,0.4015929698944092,0.0,11056.055
194,15:17:30,0.2,1000,700,4,5,49,32,22,15,31,18,17,15,2382.0,9940.898000000001,0.03468179702758789,0.01697516441345215,0.0,8059.101999999999
191,07:22:00,0.4,1000,700,5,6,34,25,13,18,26,8,7,18,1358.0,5080.948734896091,0.011324882507324219,0.004752159118652344,0.0,2919.051265103909
185,07:21:00,0.2,1000,700,5,6,89,54,39,21,28,61,33,21,3527.0,15555.145,0.11220526695251465,0.10022592544555664,0.0,45444.854999999996
199,16:04:00,0.2,1000,700,4,5,43,30,25,10,12,31,20,10,3069.0,13035.105329314078,0.039136648178100586,0.027562856674194336,0.0,17964.8953375512
191,13:41:30,0.4,1000,700,6,7,23,14,11,10,15,8,4,10,1381.0,5766.575684128705,0.004782199859619141,0.002315998077392578,0.0,2233.424315871295
187,13:47:00,0,1000,700,1,2,40,50,33,19,16,24,31,19,3316.2994362920435,14825.184999999998,0.15015125274658203,1.6776821613311768,0.0,9174.815000000002
192,14:50:30,0.4,1000,700,6,7,53,37,21,23,24,29,14,23,2090.0,8679.023,0.02838301658630371,0.019449949264526367,0.0,20320.977
191,13:41:30,0.4,1000,700,6,7,23,17,14,10,13,10,7,10,1381.0,5535.810684128705,0.004843235015869141,0.002496957778930664,0.0,4464.189315871295
187,13:47:00,0,1000,700,1,2,38,44,34,12,9,29,32,12,3338.0,14461.387999999999,0.11250996589660645,0.18282103538513184,0.0,14538.612000000001
191,07:22:00,0.4,1000,700,5,6,31,21,14,13,21,10,8,13,1358.0,5423.882734896091,0.007523059844970703,0.004133939743041992,0.0,4576.117265103909
185,07:21:00,0.2,1000,700,5,6,87,58,37,27,35,52,31,27,3527.0,15525.891,0.11765313148498535,0.15706110000610352,0.0,36474.109
199,16:04:00,0.2,1000,700,4,5,43,30,23,12,16,27,18,12,3069.0,13207.301000000001,0.04042696952819824,0.07461810111999512,0.0,13792.698999999999
198,19:44:00,0.4,1000,700,3,4,23,15,11,8,10,13,7,8,946.0,4140.563,0.0049211978912353516,0.005505800247192383,0.0,8859.437
194,15:17:30,0.2,1000,700,4,5,49,33,23,15,26,23,18,15,2382.0,10168.044322912549,0.03939199447631836,0.0233309268951416,0.0,12831.956177087526
187,13:47:00,1,1000,700,29,30,40,33,36,27,26,14,6,27,3294.0,12982.993,0.01337289810180664,0.0017240047454833984,0.0,1017.0069999999996
187,16:47:00,0.4,1000,700,12,13,45,36,31,18,16,29,18,18,3338.0,13378.504439601598,0.022466182708740234,0.011282920837402344,0.0,15621.496360398402
191,13:41:30,0,1000,700,1,2,21,21,16,7,10,11,14,7,1422.0,5863.838684128705,0.01609182357788086,0.013036966323852539,0.0,5136.161315871295
195,13:21:00,0.4,1000,700,9,10,40,36,22,24,25,15,12,24,2468.0,9517.533000000001,0.022082805633544922,0.02106189727783203,0.0,5482.466999999999
198,10:24:30,0.4,1000,700,3,4,17,15,7,12,13,4,3,12,747.0,2855.7119999999995,0.003965854644775391,0.0020198822021484375,0.0,1144.2880000000005
55,15:58:00,0.2,1000,700,4,5,72,58,37,26,33,39,32,26,4126.0,16304.230000000005,0.10274386405944824,0.0483708381652832,0.0,22695.770000000004
194,07:10:00,0.4,1000,700,9,10,51,29,24,15,18,33,14,15,2369.1220472440946,9920.453999999998,0.029061079025268555,0.058004140853881836,0.0,23079.546000000002
192,14:50:30,1,1000,700,14,15,53,30,19,26,32,21,4,26,2090.0,8373.178,0.011955976486206055,0.0021910667419433594,0.0,12626.822
155,07:44:30,1,1000,700,12,13,46,29,17,25,34,12,4,25,1868.0,8024.776000000003,0.011619806289672852,0.0013659000396728516,0.0,3975.2239999999974
155,07:44:30,0.4,1000,700,5,6,45,28,21,13,19,26,15,13,1926.0,8235.024,0.03438901901245117,0.05963706970214844,8.511128863888172e-05,17764.976000000002
191,13:41:30,1,1000,700,14,15,22,11,16,10,13,9,1,10,1422.0,5202.024684128705,0.002766132354736328,0.00045299530029296875,0.0,3797.9753158712947
199,13:24:30,0.2,1000,700,4,5,30,24,20,9,9,21,15,9,2990.0,13100.069999999942,0.011571884155273438,0.007230997085571289,0.0,7899.930000000018
196,09:57:30,0.2,1000,700,3,4,15,11,13,2,2,13,9,2,1956.0,7920.572000000001,0.002106189727783203,0.0020270347595214844,0.0,5079.427999999999
193,13:30:30,0.2,1000,700,3,4,48,38,17,25,30,18,13,25,1589.0,6875.27,0.0828390121459961,0.02460193634033203,0.0,11124.73
155,07:44:30,0,1000,700,1,2,46,35,21,16,17,29,19,16,1926.0,8383.8,0.08623719215393066,0.18299293518066406,0.0,20616.2
192,14:50:30,0,1000,700,1,2,53,40,21,21,24,29,19,21,2118.0,9385.818,0.12569427490234375,0.30408477783203125,0.0,19614.182
193,13:30:30,1,1000,700,14,15,48,28,16,27,38,10,1,27,1565.0,6125.9890000000005,0.012262105941772461,0.0010590553283691406,0.0,3874.0109999999995
194,15:17:30,1,1000,700,22,23,49,20,26,17,31,18,3,17,2343.0,9229.525000000001,0.008346080780029297,0.0011730194091796875,0.0,8770.474999999999
185,07:21:00,0,1000,700,1,2,89,58,41,19,25,64,39,19,3527.0,15636.570365722579,0.4227173328399658,0.25597596168518066,0.0,48363.43051361482
195,07:09:00,0.2,1000,700,4,5,50,40,24,21,25,25,19,21,2514.0,10648.494999999999,0.0507807731628418,0.08832406997680664,0.0,14351.505000000001
196,09:57:30,0,1000,700,1,2,15,18,17,3,2,13,15,3,1990.4809413027906,8898.246,0.009215116500854492,0.08544492721557617,0.0,4101.754000000001
194,15:17:30,0.4,1000,700,9,10,49,28,20,18,33,16,10,18,2343.0,9521.363000000001,0.012617111206054688,0.004205942153930664,0.0,6478.636999999999
55,18:56:00,0.2,1000,700,5,6,59,54,45,15,17,42,39,15,5139.0,22241.039000000004,0.15528392791748047,0.13793611526489258,0.0,19758.960999999996
185,15:27:00,0,1000,700,1,2,25,26,22,6,7,18,20,6,2126.9262258410818,9508.211,0.028300046920776367,0.007920026779174805,0.0,8491.789
198,19:44:00,0.2,1000,700,1,2,24,15,11,6,9,15,9,6,946.0,4127.227999999999,0.009762048721313477,0.0072231292724609375,0.0,10872.772
191,07:22:00,0.2,1000,700,2,3,34,27,14,16,20,14,11,16,1358.0,5479.510734896091,0.02274012565612793,0.08133196830749512,0.0,8520.489265103908
199,16:04:00,0.4,1000,700,8,9,43,28,26,11,15,28,17,11,3069.0,13377.659,0.0207369327545166,0.1182711124420166,0.0,14622.341
193,13:30:30,0,1000,700,1,2,48,32,16,18,23,25,14,18,1583.6193746381978,7079.412052382613,0.07467293739318848,0.046710968017578125,0.0,17920.588044009488
185,07:21:00,0.4,1000,700,11,12,89,48,39,21,34,55,27,21,3527.0,15337.58299999999,0.07055306434631348,0.07050418853759766,0.0,39662.41699999994
196,09:57:30,1,1000,700,14,15,15,9,17,7,11,4,2,7,1956.0,7886.512999999999,0.0019192695617675781,0.0006887912750244141,0.0,-3886.512999999999
194,15:17:30,0,1000,700,1,2,49,35,23,14,15,34,21,14,2381.7284806728712,10647.279000000004,0.09037899971008301,0.30184197425842285,0.0,23352.720999999998
191,13:41:30,0.2,1000,700,3,4,23,17,12,9,12,11,8,9,1422.0,6109.509684128705,0.008067131042480469,0.005610942840576172,0.0,4890.490315871295
185,07:21:00,1,1000,700,28,29,87,40,33,36,56,31,4,36,3472.983491410163,13603.772000000003,0.046790122985839844,0.001850128173828125,0.0,17396.227999999996
199,16:04:00,1,1000,700,19,20,39,19,25,14,17,22,5,14,3025.0,12745.410999999996,0.007714986801147461,0.0015399456024169922,0.0,9254.589000000004
185,15:27:00,1,1000,700,17,18,27,15,19,14,18,9,1,14,2159.0,7930.444000000001,0.004066944122314453,0.0007328987121582031,0.0,1069.5559999999987
198,10:24:30,0,1000,700,1,2,17,15,8,9,9,8,6,9,790.0,3530.876,0.0074100494384765625,0.012225866317749023,0.0,4469.124
199,13:24:30,0,1000,700,1,2,30,27,23,6,5,25,21,6,3030.0,13235.91299999995,0.03513908386230469,0.017674922943115234,0.0,11764.087000000021
193,13:30:30,0.4,1000,700,6,7,48,28,17,18,30,18,10,18,1569.2321045096614,6737.3240000000005,0.020769119262695312,0.007916927337646484,0.0,11262.676
199,13:24:30,0.4,1000,700,8,9,30,27,21,15,17,13,12,15,3030.0,11984.777999999998,0.011234045028686523,0.00969696044921875,0.0,1015.2220000000016
191,07:22:00,1,1000,700,13,14,33,19,16,17,21,12,2,17,1387.0,5095.854734896091,0.005630016326904297,0.0006699562072753906,0.0,6904.145265103909
195,13:21:00,1,1000,700,22,23,41,22,25,20,29,12,2,20,2468.0,9549.705,0.008285284042358398,0.0016689300537109375,0.0,2450.295
55,15:58:00,0,1000,700,1,2,72,56,43,15,16,56,41,15,4126.0,18030.684999999998,0.3219780921936035,0.4413599967956543,0.0,37969.315
199,13:24:30,1,1000,700,19,20,30,20,24,16,18,12,4,16,2990.0,12192.131999999998,0.005722999572753906,0.0014808177947998047,0.0,-192.1319999999978
195,07:09:00,0,1000,700,1,2,50,43,29,16,14,36,27,16,2514.0,11158.726286795943,0.13690614700317383,0.12495183944702148,0.0,24841.274172425827
198,10:24:30,1,1000,700,7,8,19,9,9,8,16,3,1,8,790.0,2855.7120000000004,0.0015571117401123047,0.0004220008850097656,0.0,144.28799999999956
194,07:10:00,0.2,1000,700,4,5,52,28,21,12,21,31,16,12,2372.0,10181.021,0.027611970901489258,0.08920693397521973,0.0,20818.979
195,13:21:00,0,1000,700,1,2,41,38,27,13,11,30,25,13,2556.0,11250.368000000004,0.09005022048950195,0.14145708084106445,0.0,18749.631999999998
198,10:24:30,0.2,1000,700,2,3,19,14,9,8,15,4,6,8,747.0,3162.2749999999996,0.0042629241943359375,0.003214120864868164,0.0,837.7250000000004
195,13:21:00,0.2,1000,700,4,5,41,41,27,19,18,23,22,19,2468.0,10177.479000000001,0.05319929122924805,0.08543610572814941,0.0,12822.520999999999
191,07:22:00,0,1000,700,1,2,31,25,18,9,7,24,16,9,1383.586420654996,6185.18473489609,0.03139686584472656,0.008836030960083008,0.0,17814.81526510391
187,16:47:00,0.2,1000,700,6,7,43,47,37,17,17,26,30,17,3338.0,14712.669,0.03938412666320801,0.02079486846923828,0.0,11287.331
196,16:23:30,0.2,1000,700,3,4,29,22,14,12,17,12,10,12,1984.409583035078,7358.89,0.010545015335083008,0.010510921478271484,0.0,4641.11
55,15:58:00,1,1000,700,22,23,71,40,27,36,55,16,4,36,4074.0,15644.422000000002,0.028744935989379883,0.00209808349609375,0.0,355.5779999999977
187,16:47:00,1,1000,700,29,30,43,34,37,27,27,16,7,27,3294.0,13123.513999999997,0.01278996467590332,0.0016570091247558594,0.0,2876.4860000000026
196,09:57:30,0.2,1000,700,3,4,13,12,11,5,3,10,7,5,1956.0,6891.801000000001,0.0022192001342773438,0.002226114273071289,0.0,3108.1989999999987
185,15:27:00,0.2,1000,700,3,4,26,27,19,12,13,13,15,12,2159.0,9252.3,0.01610398292541504,0.03983902931213379,0.0,3747.7000000000007
155,07:44:30,0.4,1000,700,5,6,46,33,23,16,22,24,17,16,1926.0,8458.689,0.04455089569091797,0.0663459300994873,4.6480818260812916e-05,15541.311
155,07:44:30,1,1000,700,12,13,45,23,15,21,33,12,2,21,1868.0,7437.8380000000025,0.008348941802978516,0.0010390281677246094,0.0,4562.1619999999975
187,16:47:00,0,1000,700,1,2,45,46,34,14,11,34,32,14,3338.0,14777.880999999998,0.14301180839538574,0.33170604705810547,0.0,19222.119000000002
55,15:58:00,0.2,1000,700,4,5,71,51,35,21,28,43,30,21,4126.0,16796.088000000003,0.07757210731506348,0.03785204887390137,0.0,26203.911999999997
198,10:24:30,0.4,1000,700,3,4,18,12,8,8,13,5,4,8,747.0,3117.174,0.002873659133911133,0.0012080669403076172,0.0,1882.826
191,13:41:30,0,1000,700,1,2,22,24,14,12,10,12,12,12,1422.0,6120.224684128705,0.021456241607666016,0.02281808853149414,0.0,5879.775315871295
196,16:23:30,0.4,1000,700,6,7,28,17,15,9,12,16,8,9,1954.0,8258.009000000004,0.006770133972167969,0.006986856460571289,0.0,7741.990999999998
193,08:16:30,0.2,1000,700,2,3,45,32,17,18,24,21,14,18,1472.0,6313.514000000001,0.043372154235839844,0.023890018463134766,0.0,14686.485999999992
192,08:28:00,0.4,1000,700,5,6,33,25,15,16,15,18,9,16,1991.0,8368.284,0.010281085968017578,0.012084007263183594,0.0,9631.716
155,13:50:00,0.4,1000,700,6,7,32,28,17,18,17,15,10,18,1646.0,7097.802000000001,0.01862621307373047,0.009371042251586914,0.0,7902.197999999999
55,18:56:00,1,1000,700,27,28,58,34,33,29,37,21,5,29,5139.0,19680.796000000002,0.01618194580078125,0.0023088455200195312,0.0,1319.203999999998
195,07:09:00,0.4,1000,700,9,10,49,41,27,24,34,15,17,24,2514.0,10056.279,0.030071735382080078,0.012471914291381836,0.0,4943.721
194,15:17:30,0.2,1000,700,4,5,50,39,26,18,19,31,21,18,2358.3779080171807,10111.467,0.049343109130859375,0.03108501434326172,0.0,20888.533
55,18:56:00,0.4,1000,700,11,12,62,47,37,22,21,41,25,22,5105.0,21834.296000000006,0.05092191696166992,0.19955110549926758,0.0,19165.70399999999
198,19:44:00,0.4,1000,700,3,4,24,15,11,8,9,15,7,8,946.0,4050.719,0.025008678436279297,0.004235982894897461,0.0,10949.280999999999
55,18:56:00,0,1000,700,1,2,56,51,44,9,8,48,42,9,5139.0,22594.677999999996,0.21337223052978516,0.46956896781921387,0.0,25405.322000000004
192,14:50:30,0.4,1000,700,6,7,51,36,22,21,23,28,15,21,2090.0,8524.246000000001,0.025823116302490234,0.03290700912475586,0.0,19475.754
187,13:47:00,0.4,1000,700,12,13,40,41,28,26,23,17,15,26,3338.0,13372.179999999998,0.02314019203186035,0.015023946762084961,0.0,3627.8200000000015
196,16:23:30,0.2,1000,700,3,4,27,23,17,10,14,13,13,10,1984.409583035078,7539.227,0.010839223861694336,0.01516103744506836,0.0,5460.773
193,08:16:30,0.4,1000,700,5,6,43,25,16,15,22,21,10,15,1472.0,6100.402,0.015804767608642578,0.0039958953857421875,0.0,14899.598
192,08:28:00,0.2,1000,700,2,3,30,36,18,21,16,14,15,21,1991.0,8575.128,0.037175893783569336,0.14314723014831543,0.0,5424.871999999999
198,19:44:00,1,1000,700,7,8,23,9,10,7,11,12,2,7,946.0,3464.248,0.0020728111267089844,0.0010449886322021484,0.0,8535.752
195,13:21:00,0,1000,700,1,2,42,43,28,17,16,26,26,17,2556.0,11181.963000000002,0.11685490608215332,0.42935681343078613,0.0,14818.036999999998
191,07:22:00,0,1000,700,1,2,34,24,16,10,12,22,14,10,1387.0,6003.435734896091,0.03166794776916504,0.02302694320678711,0.0,15996.564265103909
55,15:58:00,0.4,1000,700,9,10,71,48,32,26,38,33,22,26,4126.0,13418.985,0.05809521675109863,0.0103759765625,0.0,19581.015
155,07:44:30,0.2,1000,700,2,3,46,34,21,16,17,29,18,16,1926.0,8480.105,0.06845617294311523,0.1409440040588379,0.0,20519.895
195,07:09:00,0,1000,700,1,2,49,43,27,18,17,32,25,18,2481.020971251557,11091.15614988298,0.13468480110168457,0.18068289756774902,0.0,20908.844206574162
198,19:44:00,0,1000,700,1,2,24,19,12,9,10,14,10,9,946.0,3878.4380000000006,0.014864206314086914,0.012022018432617188,0.0,10121.562
185,15:27:00,0.4,1000,700,7,8,21,22,18,12,12,9,10,12,2113.0,8430.896,0.00592494010925293,0.002112865447998047,0.0,569.1039999999994
196,09:57:30,0.4,1000,700,6,7,15,15,15,7,8,7,8,7,1965.163922691485,8078.554999999999,0.0026900768280029297,0.002064943313598633,0.0,-1078.5549999999994
198,10:24:30,0,1000,700,1,2,18,14,8,8,11,7,6,8,781.437902648533,3493.34,0.006857872009277344,0.011670827865600586,0.0,3506.66
195,07:09:00,1,1000,700,22,23,49,29,27,25,37,12,4,25,2447.0,9346.733,0.01306605339050293,0.0018498897552490234,0.0,2653.267
155,13:50:00,1,1000,700,14,15,32,21,17,19,24,8,2,19,1607.0,6196.468000000001,0.00580906867980957,0.0011260509490966797,0.0,1803.5319999999992
199,16:04:00,1,1000,700,19,20,45,23,24,19,22,23,4,19,3025.0,12021.288999999999,0.00932621955871582,0.0014390945434570312,0.0,10978.711000000001
187,13:47:00,0.2,1000,700,6,7,38,41,32,16,13,25,25,16,3338.0,13294.3,0.03211688995361328,0.011316061019897461,0.0,11705.7
185,15:27:00,1,1000,700,17,18,26,17,21,14,17,9,3,14,2113.0,8224.214,0.00423121452331543,0.001010894775390625,0.0,775.7860000000001
194,07:10:00,1,1000,700,22,23,52,18,24,17,36,16,1,17,2372.0,8741.315,0.008102178573608398,0.0007750988006591797,0.0,7258.6849999999995
192,14:50:30,0.2,1000,700,3,4,53,39,19,24,30,23,15,24,2118.0,8829.191000000012,0.05814719200134277,0.190155029296875,0.0,14170.808999999996
196,16:23:30,0,1000,700,1,2,29,23,20,5,5,24,18,5,2060.0,8826.838999999998,0.02554607391357422,0.8671078681945801,0.0,15173.161000000002
192,08:28:00,0,1000,700,1,2,30,37,21,18,15,15,19,18,1991.0,8778.301,0.06614208221435547,0.42514705657958984,0.0,6221.6990000000005
193,08:16:30,0,1000,700,1,2,45,33,17,18,23,22,15,18,1472.0,6521.557001346382,0.07480597496032715,0.03826403617858887,0.0,15478.443042598155
55,18:56:00,0.2,1000,700,5,6,58,57,48,15,15,43,42,15,5139.0,22554.17000000001,0.18019723892211914,0.1335461139678955,0.0,20445.82999999999
155,13:50:00,0,1000,700,1,2,32,32,17,17,14,18,15,17,1646.0,7330.581999999999,0.05150723457336426,0.015039920806884766,0.0,10669.418000000001
199,16:04:00,0,1000,700,1,2,42,35,29,8,9,33,27,8,3025.0,13447.528272129593,0.07828783988952637,0.044497013092041016,0.0,19552.472687116893
195,07:09:00,0.2,1000,700,4,5,49,40,24,21,27,22,19,21,2514.0,10977.742,0.05227518081665039,0.18626093864440918,0.0,11022.258000000013
194,15:17:30,1,1000,700,22,23,50,25,27,21,23,27,4,21,2343.0,9229.525000000001,0.011190176010131836,0.0014719963073730469,0.0,17770.475
196,16:23:30,1,1000,700,14,15,29,12,17,10,21,8,2,10,2060.0,7485.589,0.00347900390625,0.0007119178771972656,0.0,514.4110000000001
194,07:10:00,0,1000,700,1,2,51,36,25,13,14,37,23,13,2372.0,10407.921,0.09916973114013672,0.2380051612854004,0.0,26592.078999999998
192,08:28:00,1,1000,700,12,13,33,18,16,15,16,17,3,15,1966.275724767358,7896.714000000001,0.0048828125,0.001049041748046875,0.0,9103.286
155,13:50:00,0.2,1000,700,3,4,32,26,16,14,17,15,12,14,1646.0,6856.992,0.01962113380432129,0.022947072982788086,0.0,8143.008
193,08:16:30,1,1000,700,13,14,43,18,14,18,32,11,0,18,1444.0,5418.034000000001,0.006150960922241211,0.0006289482116699219,0.0,5581.965999999999
155,13:50:00,0.2,1000,700,3,4,32,31,16,19,17,15,12,19,1646.0,6984.609,0.030230045318603516,0.01893782615661621,0.0,8015.391
193,08:16:30,1,1000,700,13,14,45,23,15,22,34,11,1,22,1444.0,5574.992,0.009372949600219727,0.0008301734924316406,0.0,5425.008
192,08:28:00,1,1000,700,12,13,30,26,17,22,19,11,4,22,1966.275724767358,8056.001000000001,0.007544755935668945,0.0013861656188964844,0.0,2943.998999999999
195,07:09:00,0.2,1000,700,4,5,49,46,26,25,28,21,21,25,2514.0,11028.344000000001,0.06673789024353027,0.15947294235229492,0.0,9971.655999999999
196,16:23:30,1,1000,700,14,15,29,14,17,12,21,8,2,12,1954.0,7484.485000000001,0.004761934280395508,0.0010230541229248047,0.0,515.5149999999994
194,07:10:00,0,1000,700,1,2,52,31,20,13,17,35,18,13,2351.966267000713,10514.23,0.07559800148010254,0.211533784866333,0.0,24485.77
198,19:44:00,0.2,1000,700,1,2,24,17,10,9,9,15,8,9,918.0,4050.719,0.012202024459838867,0.011770009994506836,0.0,10949.280999999999
55,18:56:00,0.2,1000,700,5,6,62,52,47,11,11,51,41,11,5139.0,22466.398396121855,0.14121699333190918,0.2268810272216797,0.0,28533.602483929917
185,15:27:00,0,1000,700,1,2,26,28,21,9,9,17,19,9,2113.0,9391.164936179839,0.033490896224975586,0.02816295623779297,0.0,7608.835063820119
194,15:17:30,0.4,1000,700,9,10,50,34,24,20,22,28,14,20,2343.0,9575.699,0.017246007919311523,0.006796836853027344,0.0,18424.301
155,13:50:00,0,1000,700,1,2,32,28,18,12,14,18,16,12,1645.2471772763165,7354.912981296056,0.04012799263000488,0.02126598358154297,0.0,10645.087018703725
199,16:04:00,0,1000,700,1,2,45,37,23,16,13,32,21,16,3025.0,13516.563206836641,0.0926520824432373,0.05944180488586426,0.0,18483.437659828796
193,08:16:30,0,1000,700,1,2,43,29,17,14,21,22,15,14,1472.0,6423.114,0.0553281307220459,0.04500102996826172,0.0,15576.886
192,08:28:00,0,1000,700,1,2,33,29,18,13,12,21,16,13,1991.0,8808.143,0.04369211196899414,0.13907194137573242,0.0,12191.857
194,07:10:00,1,1000,700,22,23,51,19,26,16,28,23,3,16,2334.0,8928.65,0.008768081665039062,0.0011289119720458984,0.0,14071.35
192,14:50:30,0.2,1000,700,3,4,51,38,22,20,21,30,18,20,2118.0,9019.021,0.04759788513183594,0.13295197486877441,0.0,20980.979
196,16:23:30,0,1000,700,1,2,29,20,16,6,7,22,14,6,1954.0,8633.272000000003,0.019921302795410156,0.7753908634185791,0.0,13366.727999999997
194,15:17:30,0,1000,700,1,2,50,42,29,15,14,36,27,15,2382.0,10629.806,0.13460302352905273,0.046000003814697266,0.0,25370.194
155,13:50:00,1,1000,700,14,15,32,24,18,21,21,11,3,21,1607.0,6224.586000000001,0.0070950984954833984,0.0014300346374511719,0.0,4775.413999999999
199,16:04:00,1,1000,700,19,20,42,20,28,12,18,24,8,12,3025.0,12749.722999999998,0.007103919982910156,0.0026988983154296875,0.0,11250.277000000002
187,13:47:00,0.2,1000,700,6,7,40,46,30,23,19,21,23,23,3338.0,14271.54399999999,0.04182600975036621,0.03566694259643555,0.0,6728.456
195,07:09:00,1,1000,700,22,23,49,31,26,28,35,14,3,28,2447.0,9428.221,0.014979124069213867,0.0025320053100585938,0.0,4571.779
191,07:22:00,1,1000,700,13,14,34,15,16,13,21,13,2,13,1387.0,5095.854734896091,0.0049059391021728516,0.0006961822509765625,0.0,7904.145265103909
196,09:57:30,0.4,1000,700,6,7,13,11,14,4,3,10,7,4,1956.0,7355.434,0.0016090869903564453,0.0009739398956298828,0.0,2644.566
195,13:21:00,1,1000,700,22,23,42,24,27,20,23,19,4,20,2468.0,9746.443,0.008589744567871094,0.001226186752319336,0.0,9253.557
198,19:44:00,0,1000,700,1,2,23,15,11,6,7,16,9,6,946.0,3955.6100000000006,0.009943962097167969,0.008014917373657227,0.0,12044.39
185,15:27:00,0.4,1000,700,7,8,26,25,18,15,17,9,10,15,2127.43450250537,8830.391999999996,0.008414983749389648,0.0030519962310791016,0.0,169.6080000000038
155,07:44:30,0.2,1000,700,2,3,46,36,23,16,21,25,20,16,1926.0,8356.26,0.07466816902160645,0.11127400398254395,0.0,16643.739999999998
195,07:09:00,0,1000,700,1,2,49,48,29,21,22,27,27,21,2514.0,11090.02,0.16733598709106445,0.8043859004974365,0.0,15909.98
198,10:24:30,1,1000,700,7,8,18,10,9,9,14,4,1,9,790.0,2855.7120000000004,0.0018630027770996094,0.0004968643188476562,0.0,1144.2879999999996
55,15:58:00,0.4,1000,700,9,10,71,47,30,27,39,32,20,27,4126.0,13703.951000000003,0.053498029708862305,0.012993097305297852,0.0,18296.049
198,10:24:30,0.2,1000,700,2,3,18,13,6,10,13,5,3,10,790.0,3117.174,0.003741025924682617,0.002473115921020508,0.0,1882.826
196,16:23:30,0.2,1000,700,3,4,28,19,15,8,10,18,11,8,1954.0,8575.112000000001,0.009886026382446289,0.041229963302612305,0.0,9424.887999999999
193,08:16:30,0.4,1000,700,5,6,45,30,16,20,27,18,10,20,1472.0,5965.674000000001,0.025860071182250977,0.012407779693603516,0.0,12034.326
192,08:28:00,0.2,1000,700,2,3,33,28,19,12,12,21,16,12,1991.0,8808.142999999998,0.025454044342041016,0.040641069412231445,0.0,12191.857
198,19:44:00,1,1000,700,7,8,24,13,10,11,16,8,2,11,918.0,3464.248,0.0033469200134277344,0.001020193099975586,0.0,4535.752
187,13:47:00,0.4,1000,700,12,13,38,36,29,20,17,21,16,20,3314.5207140300627,12577.065999999999,0.020315885543823242,0.008316993713378906,0.0,8422.934000000001
192,14:50:30,0.4,1000,700,6,7,53,37,19,25,32,21,12,25,2118.0,8956.101,0.02546834945678711,0.01862478256225586,0.0,12043.899
55,18:56:00,0,1000,700,1,2,58,52,43,11,11,47,41,11,5139.0,22551.705,0.2265491485595703,0.5547349452972412,0.0,24448.295
55,18:56:00,0.4,1000,700,11,12,58,52,35,29,27,31,23,29,5139.0,21649.46829471807,0.06665992736816406,0.09169816970825195,0.0,9350.532627631128
195,07:09:00,0.4,1000,700,9,10,49,36,23,23,30,19,13,23,2499.1709466714237,9950.251,0.023682117462158203,0.013026952743530273,0.0,9049.749
55,18:56:00,1,1000,700,27,28,56,34,30,32,40,16,2,32,5139.0,19146.540000000005,0.01777505874633789,0.0022020339965820312,0.0,-3146.5400000000045
155,13:50:00,0.4,1000,700,6,7,32,24,16,15,20,12,9,15,1607.0,6894.880999999999,0.010533809661865234,0.017177104949951172,0.0,5105.119000000001
196,16:23:30,0.4,1000,700,6,7,27,20,17,10,14,13,10,10,1984.409583035078,7539.2270000000435,0.009501934051513672,0.010789155960083008,0.0,5460.773000000029
193,08:16:30,0.2,1000,700,2,3,43,28,17,14,21,22,14,14,1472.0,6494.521999999999,0.03378725051879883,0.01352691650390625,0.0,15505.478000000001
192,08:28:00,0.4,1000,700,5,6,30,33,19,20,16,14,13,20,1976.0695687186817,8575.128325438396,0.015336990356445312,0.011493206024169922,0.0,5424.872702244498
187,16:47:00,0,1000,700,1,2,43,52,37,17,17,26,35,17,3338.0,14712.669,0.17302870750427246,1.7632861137390137,0.0,11287.331
55,15:58:00,0.2,1000,700,4,5,71,52,35,22,27,44,30,22,4126.0,14362.017999999998,0.0840449333190918,0.02269911766052246,0.0,29637.982000000004
155,07:44:30,0.4,1000,700,5,6,46,31,21,16,19,27,15,16,1926.0,8356.608,0.03532743453979492,0.0156400203704834,0.0,18643.392
185,15:27:00,0.2,1000,700,3,4,21,25,19,10,8,13,15,10,2159.0,9443.088,0.01291513442993164,0.005975008010864258,0.0,3556.9120000000003
191,13:41:30,1,1000,700,14,15,22,14,16,13,14,8,1,13,1422.0,5202.024684128705,0.00360870361328125,0.0007460117340087891,0.0,2797.9753158712947
196,09:57:30,0.2,1000,700,3,4,15,16,14,6,5,10,10,6,2020.0,8226.288,0.003865957260131836,0.007277965545654297,0.0,1773.7119999999995
187,16:47:00,1,1000,700,29,30,45,27,36,21,21,24,6,21,3294.0,13071.392999999998,0.01044464111328125,0.0018770694732666016,0.0,10928.607000000002
155,07:44:30,0,1000,700,1,2,45,32,23,11,14,31,21,11,1926.0,8565.212,0.07025980949401855,0.16384387016296387,0.0,22434.788
