route,route_time,percentage_comp_stops,benefit,walking_distance,compulsory_stops,requests,used-nodes,unused_nodes,unserved_requests,served_requests,optional_stops_visited,total_used-travel_time,travel_distance,build_time,solve_time,optimality_gap,obj_val
55,18:56:00,0.4,1000,700,12,58,17,22,54,4,5,6206.33774755428,17050.415,,0.0005328655242919922,,-13050.415
195,07:09:00,0.4,1000,700,10,48,16,15,36,12,6,2097.8154154736367,9982.084,,0.0002789497375488281,,2017.9159999999993
196,16:23:30,0.4,1000,700,7,29,9,12,24,5,2,1921.0107447506525,6803.287,,0.00011706352233886719,,-1803.2870000000003
199,16:04:00,0,1000,700,2,43,4,23,41,2,2,0.0,9325.216000000002,,0.0002219676971435547,,-7325.216000000002
192,14:50:30,0.2,1000,700,4,53,15,10,34,19,11,2297.7564572894335,9147.614,,0.0003178119659423828,,9852.386
195,07:09:00,1,1000,700,23,48,24,11,18,30,1,3834.6149486995964,9936.379,,0.00016832351684570312,,20063.621
196,09:57:30,0.4,1000,700,7,15,9,7,13,2,2,2265.126103555238,7036.397,,9.512901306152344e-05,,-5036.397
155,07:44:30,0.2,1000,700,3,45,8,19,40,5,5,1650.5349484013313,6455.957000000001,,0.0003650188446044922,,-1455.9570000000012
55,15:58:00,0.4,1000,700,10,71,21,17,42,29,11,4219.906883798612,13922.77,,0.0005340576171875,,15077.23
196,16:23:30,0.2,1000,700,4,29,7,13,25,4,3,1666.3697208303565,6996.451,,0.00020313262939453125,,-2996.451
195,07:09:00,0,1000,700,2,48,6,25,44,4,4,0.0,6581.007,,0.0003261566162109375,,-2581.0069999999996
199,16:04:00,1,1000,700,20,43,22,6,10,33,2,4797.591192436172,11861.190999999997,,0.000148773193359375,,21138.809
55,18:56:00,0.2,1000,700,6,58,13,24,54,4,7,3869.3160418157786,18408.414,,0.0003879070281982422,,-14408.414
195,07:09:00,0.2,1000,700,5,48,12,19,38,10,7,1388.4347933070858,9480.22,,0.0004570484161376953,,519.7800000000007
196,09:57:30,0.2,1000,700,4,15,11,3,9,6,7,2041.4886363636324,8698.89,,8.916854858398438e-05,,-2698.8899999999994
155,07:44:30,0.4,1000,700,6,45,10,16,40,5,4,1866.6084392149824,6570.066000000001,,0.00035309791564941406,,-1570.0660000000007
55,15:58:00,0.2,1000,700,5,71,17,19,55,16,12,3598.666800882842,14135.956,,0.0005121231079101562,,1864.0439999999999
192,14:50:30,0.4,1000,700,7,53,15,10,31,22,8,2671.9938857074594,8692.903999999999,,0.00019097328186035156,,13307.096000000001
194,15:17:30,1,1000,700,23,47,24,10,22,25,1,3689.2199206633304,9042.614999999998,,0.00019812583923339844,,15957.385000000002
185,15:27:00,1,1000,700,18,26,18,8,7,19,0,3309.497062157003,8201.27,,7.605552673339844e-05,,10798.73
198,10:24:30,0,1000,700,2,17,8,4,12,5,6,0.0,4204.201,,8.0108642578125e-05,,795.799
191,07:22:00,0,1000,700,2,31,5,13,27,4,3,0.0,6942.2717348960905,,0.0001342296600341797,,-2942.2717348960905
195,13:21:00,0,1000,700,2,40,6,27,37,3,4,0.0,6994.58,,0.00021409988403320312,,-3994.58
194,15:17:30,0.2,1000,700,5,48,12,19,42,6,7,2344.6099006800287,9326.760999999999,,0.000576019287109375,,-3326.7609999999986
198,19:44:00,0.4,1000,700,4,23,9,7,15,8,5,1127.7116663683992,4297.6269999999995,,0.000102996826171875,,3702.3730000000005
191,13:41:30,0,1000,700,2,23,8,7,18,5,6,0.0,8042.143684128705,,0.00012993812561035156,,-3042.143684128705
198,10:24:30,0.4,1000,700,4,17,7,5,13,4,3,781.8411700668148,3332.3289999999997,,6.4849853515625e-05,,667.6710000000003
155,07:44:30,1,1000,700,13,45,15,11,26,19,2,2832.704075697926,7625.615000000001,,0.0001609325408935547,,11374.384999999998
155,07:44:30,0,1000,700,2,45,10,17,39,6,8,0.0,6315.522000000001,,0.0003247261047363281,,-315.52200000000084
191,13:41:30,1,1000,700,15,23,15,5,5,18,0,2174.366992181873,5202.024684128705,,5.0067901611328125e-05,,12797.975315871296
198,10:24:30,0.2,1000,700,3,17,10,2,9,8,7,802.0583020162303,3598.661,,8.392333984375e-05,,4401.339
198,10:24:30,1,1000,700,8,17,7,5,9,8,-1,1094.5320851228826,2855.726,,3.3855438232421875e-05,,5144.273999999999
195,13:21:00,1,1000,700,23,40,26,10,13,27,3,3757.3509156525906,10131.736,,0.0001888275146484375,,16868.264
191,07:22:00,1,1000,700,14,31,13,6,7,24,-1,2078.2972420168444,5095.854734896091,,5.3882598876953125e-05,,18904.145265103907
194,15:17:30,0,1000,700,2,48,12,19,41,7,10,0.0,10479.804,,0.0003941059112548828,,-3479.804
198,19:44:00,0.2,1000,700,2,23,7,9,19,4,5,0.0,4825.687,,0.0001289844512939453,,-825.6869999999999
194,15:17:30,0.4,1000,700,10,48,21,10,29,19,11,3003.2242230374613,9620.998,,0.0004391670227050781,,9379.002
185,15:27:00,0,1000,700,2,26,5,19,23,3,3,0.0,7910.573999999999,,0.0001499652862548828,,-4910.573999999999
195,13:21:00,0.2,1000,700,5,40,17,18,28,12,12,2433.285694046768,10288.187,,0.00033402442932128906,,1711.813
194,07:10:00,0.2,1000,700,5,51,16,12,42,9,11,3145.047557265567,12724.312999999998,,0.00039196014404296875,,-3724.3129999999983
55,15:58:00,0,1000,700,2,71,7,29,67,4,5,0.0,14611.226999999999,,0.0005688667297363281,,-10611.226999999999
199,13:24:30,0,1000,700,2,30,7,18,24,6,5,0.0,9165.827,,0.00017118453979492188,,-3165.8269999999993
196,09:57:30,1,1000,700,15,15,15,4,10,5,0,2840.4092773204466,7721.192000000001,,6.699562072753906e-05,,-2721.192000000001
185,07:21:00,1,1000,700,29,89,33,15,31,58,4,5361.530086793129,13893.807000000003,,0.0004076957702636719,,44106.193
191,07:22:00,0.2,1000,700,3,31,10,8,23,8,7,834.6575751712226,6656.003734896091,,0.00015020370483398438,,1343.9962651039086
199,16:04:00,0.4,1000,700,9,43,16,9,32,11,7,3831.869407659273,11824.998,,0.00025391578674316406,,-824.9979999999996
193,13:30:30,1,1000,700,15,48,15,9,14,34,0,2466.4846993557585,6152.229,,0.00010395050048828125,,27847.771
193,13:30:30,0.2,1000,700,4,48,8,16,43,5,4,1858.5818345860098,6994.561000000001,,0.00027108192443847656,,-1994.5610000000006
199,13:24:30,0.2,1000,700,5,30,13,13,21,9,8,3678.348298437122,13304.889,,0.00023603439331054688,,-4304.888999999999
192,14:50:30,1,1000,700,15,53,17,9,11,42,2,3073.455246361249,7889.753,,0.0001010894775390625,,34110.247
187,16:47:00,0.4,1000,700,13,43,22,12,24,19,9,4306.699601825341,13156.854999999998,,0.0002551078796386719,,5843.145000000002
187,13:47:00,1,1000,700,30,38,36,6,9,29,6,5362.074668933426,13369.652999999998,,0.0002009868621826172,,15630.347000000002
185,07:21:00,0.2,1000,700,6,89,21,24,75,14,15,4001.7854927225017,14987.596999999998,,0.0009629726409912109,,-987.5969999999979
191,13:41:30,0.4,1000,700,7,23,6,9,18,5,-1,1938.555319848303,5095.779684128705,,4.506111145019531e-05,,-95.77968412870541
187,13:47:00,0,1000,700,2,38,13,19,29,9,11,0.0,9048.344000000001,,0.0003941059112548828,,-48.34400000000096
191,07:22:00,0.4,1000,700,6,31,10,8,24,7,4,1925.352829883701,5727.376734896091,,0.00012493133544921875,,1272.623265103909
199,16:04:00,0.2,1000,700,5,43,12,14,38,5,7,3106.5545514197147,11853.653,,0.0003540515899658203,,-6853.653
195,13:21:00,0.4,1000,700,10,40,17,18,28,12,7,2633.722306728705,9864.884999999998,,0.00022292137145996094,,2135.1150000000016
194,07:10:00,0.4,1000,700,10,51,18,11,41,10,8,3079.139577368169,9517.488000000001,,0.00039386749267578125,,482.5119999999988
192,14:50:30,0,1000,700,2,53,7,19,48,5,5,0.0,6719.268,,0.0002906322479248047,,-1719.268
185,07:21:00,0,1000,700,2,89,12,35,82,7,10,0.0,16336.698000000002,,0.0008089542388916016,,-9336.698000000002
196,09:57:30,0,1000,700,2,15,1,11,15,0,-1,0.0,1397.115,,4.696846008300781e-05,,-1397.115
193,13:30:30,0,1000,700,2,48,10,13,40,8,8,0.0,8377.9,,0.00032520294189453125,,-377.89999999999964
185,07:21:00,0.4,1000,700,12,89,21,23,72,17,9,4494.493915533283,13948.713,,0.0010480880737304688,,3051.2870000000003
191,13:41:30,0.2,1000,700,4,23,8,7,18,5,4,1854.0212289392075,7163.071684128706,,0.00017499923706054688,,-2163.071684128706
193,13:30:30,0.4,1000,700,7,48,9,15,38,10,2,2261.8948043426353,5908.504,,0.0002510547637939453,,4091.496
199,13:24:30,0.4,1000,700,9,29,16,9,13,16,7,3738.348298437122,13304.889,,0.00014281272888183594,,2695.111000000001
199,13:24:30,1,1000,700,20,30,23,7,9,21,3,4653.043299630153,11925.976999999999,,0.00012803077697753906,,9074.023000000001
187,16:47:00,0.2,1000,700,7,43,20,13,28,15,13,3954.6453934025267,15698.054999999998,,0.00036787986755371094,,-698.0549999999985
55,15:58:00,1,1000,700,23,71,26,15,26,45,3,6495.749187246474,16253.357,,0.0002720355987548828,,28746.643
187,16:47:00,1,1000,700,30,43,33,7,10,33,3,5362.074668933426,13112.317,,0.0001761913299560547,,19887.683
185,15:27:00,0.2,1000,700,4,26,10,14,20,6,6,2931.312157003107,10850.081999999999,,0.00013899803161621094,,-4850.0819999999985
192,08:28:00,0.4,1000,700,6,33,16,6,20,13,10,2014.635364471491,9745.639,,0.0002009868621826172,,3254.361000000001
55,18:56:00,1,1000,700,28,58,30,13,17,41,2,8273.570172691485,19607.692000000003,,0.00023889541625976562,,21392.307999999997
193,08:16:30,0.4,1000,700,6,43,12,10,20,23,6,1801.051561381526,6128.790999999999,,0.00014400482177734375,,16871.209000000003
198,19:44:00,1,1000,700,8,23,9,7,13,10,1,1168.2666875447467,3616.9899999999993,,9.083747863769531e-05,,6383.01
155,13:50:00,1,1000,700,15,32,18,7,15,17,3,2532.1050838105366,6709.258,,0.00011992454528808594,,10290.742
187,13:47:00,0.2,1000,700,7,38,19,15,24,14,12,3272.4601676210877,13910.864999999998,,0.0004248619079589844,,89.13500000000204
196,16:23:30,0,1000,700,2,29,2,17,28,1,0,0.0,2999.726,,0.0001220703125,,-1999.726
194,07:10:00,0,1000,700,2,51,7,21,48,3,5,0.0,9594.103,,0.0002880096435546875,,-6594.102999999999
192,08:28:00,1,1000,700,13,33,16,7,12,21,3,3037.035127356241,8482.752,,9.894371032714844e-05,,12517.248
155,13:50:00,0.2,1000,700,4,32,12,10,18,14,8,1698.5870839298514,6577.149,,0.000213623046875,,7422.851
193,08:16:30,1,1000,700,14,43,16,7,10,33,2,2253.105195657361,6066.829000000001,,0.0001049041748046875,,26933.171
196,16:23:30,1,1000,700,15,29,15,8,18,11,0,2893.0054357551926,7484.494,,0.0001087188720703125,,3515.5060000000003
155,13:50:00,0,1000,700,2,32,9,13,27,5,7,0.0,6592.378,,0.00017905235290527344,,-1592.3779999999997
193,08:16:30,0,1000,700,2,43,8,15,30,13,6,0.0,8409.283,,0.000225067138671875,,4590.717000000001
192,08:28:00,0,1000,700,2,33,8,16,27,6,6,0.0,6037.745,,0.0002422332763671875,,-37.74499999999989
194,07:10:00,1,1000,700,23,51,24,8,19,32,1,3673.780079336673,8928.65,,0.0001583099365234375,,23071.35
198,19:44:00,0,1000,700,2,23,7,9,19,4,5,0.0,4825.687,,0.0001342296600341797,,-825.6869999999999
185,15:27:00,0.4,1000,700,8,26,18,8,14,12,10,3253.2894148174746,10537.218,,0.00017881393432617188,,1462.7819999999992
192,08:28:00,0.2,1000,700,3,33,10,14,26,7,7,1637.167516702466,9174.388,,0.0002810955047607422,,-2174.388000000001
187,13:47:00,0.4,1000,700,13,38,23,11,20,18,10,4136.814543068474,12798.054,,0.0003027915954589844,,5201.946
55,18:56:00,0,1000,700,2,58,9,28,53,5,7,0.0,19473.454999999998,,0.0005400180816650391,,-14473.454999999998
155,13:50:00,0.4,1000,700,7,32,14,9,15,17,7,2298.6393685874427,7816.57,,0.00017881393432617188,,9183.43
193,08:16:30,0.2,1000,700,3,43,8,15,27,16,5,1649.306713791455,6647.288000000001,,0.00024437904357910156,,9352.712
187,16:47:00,0,1000,700,2,43,8,26,39,4,6,0.0,8424.34,,0.0002570152282714844,,-4424.34
