route,route_starting_time,percentage_of_compulsory_stops,benefit,walking_distance,num_segments,compulsory_stops,requests,number_optional_stops,used_nodes,unused_nodes,unserved_requests,served_requests,opt_stops_visited,opt_stops_not_visited,total_used-travel_time,travel_distance,build_time,solve_time,optimality_gap,obj_val
55,18:56:00,0.4,1100,500,11,12,58,42,35,19,19,39,23,19,5139.0,22378.581,0.052999019622802734,1.953320026397705,0.0,20521.419
195,07:09:00,0.4,1100,500,9,10,48,31,22,19,31,17,12,19,2447.0,10167.859999999999,0.022238969802856445,0.010757923126220703,0.0,8532.140000000001
196,16:23:30,0.4,1100,500,6,7,29,20,15,12,12,17,8,12,2060.0,8070.053999999999,0.009006977081298828,0.017250776290893555,0.0,10629.946
199,16:04:00,0,1100,500,1,2,43,33,25,10,14,29,23,10,3069.0,13697.976999999999,0.07364797592163086,0.1311938762664795,0.0,18202.023
192,14:50:30,0.2,1100,500,3,4,53,38,22,20,28,25,18,20,2118.0,9095.5,0.05357718467712402,0.1282360553741455,0.0,18404.5
195,07:09:00,1,1100,500,22,23,48,24,26,21,34,14,3,21,2459.528901216894,9635.070999999998,0.010592937469482422,0.0017452239990234375,0.0,5764.929000000002
196,09:57:30,0.4,1100,500,6,7,15,15,18,4,6,9,11,4,1956.0,8197.720000000001,0.003062009811401367,0.0016999244689941406,0.0,1702.2799999999988
155,07:44:30,0.2,1100,500,2,3,45,33,19,17,20,25,16,17,1926.0,8477.269,0.06929683685302734,0.03637504577636719,0.0,19022.731
55,15:58:00,0.4,1100,500,9,10,71,50,26,34,48,23,16,34,4126.0,13052.034,0.06352400779724121,0.02972888946533203,0.0,12247.966
196,16:23:30,0.2,1100,500,3,4,29,22,15,11,11,18,11,11,1954.0,8481.37,0.011033296585083008,0.089263916015625,0.0,11318.63
195,07:09:00,0,1100,500,1,2,48,38,27,13,15,33,25,13,2514.0,10919.939,0.10848116874694824,0.23906803131103516,0.0,25380.061
199,16:04:00,1,1100,500,19,20,43,18,24,14,24,19,4,14,3025.0,12511.964999999998,0.007995843887329102,0.0027010440826416016,0.0,8388.035000000002
55,18:56:00,0.2,1100,500,5,6,58,48,44,10,11,47,38,10,5139.0,22730.953000000005,0.1177070140838623,0.5847511291503906,0.0,28969.046999999995
195,07:09:00,0.2,1100,500,4,5,48,35,24,16,22,26,19,16,2514.0,10751.148000000001,0.040731191635131836,0.1516740322113037,0.0,17848.851999999963
196,09:57:30,0.2,1100,500,3,4,15,16,17,3,4,11,13,3,2020.0,8184.095000000002,0.0043392181396484375,0.007616996765136719,0.0,3915.9049999999993
155,07:44:30,0.4,1100,500,5,6,45,30,17,19,25,20,11,19,1926.0,8149.008000000002,0.034668684005737305,0.018323898315429688,0.0,13850.991999999998
55,15:58:00,0.2,1100,500,4,5,71,53,34,24,32,39,29,24,4126.0,15916.99199999992,0.08444476127624512,0.07261991500854492,8.089488333750785e-15,26983.007999999834
192,14:50:30,0.4,1100,500,6,7,53,36,24,19,29,24,17,19,2090.0,9008.505000000041,0.024603843688964844,0.02300715446472168,0.0,17391.495000000134
194,15:17:30,1,1100,500,22,23,48,17,25,15,25,23,2,15,2343.0,9042.614999999998,0.00840902328491211,0.0011889934539794922,0.0,16257.385000000002
185,15:27:00,1,1100,500,17,18,26,18,23,13,20,6,5,13,2113.0,8614.527999999998,0.005489826202392578,0.000985860824584961,0.0,-2014.5279999999984
198,10:24:30,0,1100,500,1,2,17,17,9,10,10,7,7,10,790.0,3510.5789999999997,0.009205102920532227,0.006136178970336914,0.0,4189.421
191,07:22:00,0,1100,500,1,2,31,24,14,12,16,15,12,12,1387.0,6152.289734896091,0.028809785842895508,0.01742720603942871,0.0,10347.71026510391
195,13:21:00,0,1100,500,1,2,40,42,27,17,17,23,25,17,2556.0,11374.161000000002,0.11031293869018555,0.4260671138763428,0.0,13925.838999999998
194,15:17:30,0.2,1100,500,4,5,48,28,22,11,22,26,17,11,2356.8992931281246,10297.189999999999,0.027730941772460938,0.0046138763427734375,0.0,18302.81
198,19:44:00,0.4,1100,500,3,4,23,13,11,6,8,15,7,6,929.594890837514,3879.101,0.003793954849243164,0.0041179656982421875,0.0,12620.899
191,13:41:30,0,1100,500,1,2,23,18,11,9,12,11,9,9,1422.0,6109.509684128705,0.013046979904174805,0.009772062301635742,0.0,5990.490315871295
198,10:24:30,0.4,1100,500,3,4,17,15,9,10,14,3,5,10,747.0,3225.6719999999996,0.0039560794830322266,0.0014820098876953125,0.0,74.32800000000043
155,07:44:30,1,1100,500,12,13,45,24,15,22,32,13,2,22,1868.0,7659.410000000001,0.008765935897827148,0.0014290809631347656,0.0,6640.589999999999
155,07:44:30,0,1100,500,1,2,45,34,21,15,16,29,19,15,1926.0,8514.778,0.08350419998168945,0.028136014938354492,0.0,23385.222
191,13:41:30,1,1100,500,14,15,23,11,15,11,18,5,0,11,1422.0,5202.024684128705,0.002769947052001953,0.0005540847778320312,0.0,297.9753158712947
198,10:24:30,0.2,1100,500,2,3,17,16,8,11,14,3,5,11,747.0,3225.672000000005,0.005424976348876953,0.004355907440185547,0.0,74.3280000000068
198,10:24:30,1,1100,500,7,8,17,12,9,11,15,2,1,11,790.0,2855.7120000000004,0.0020720958709716797,0.000637054443359375,0.0,-655.7120000000004
195,13:21:00,1,1100,500,22,23,40,27,26,24,30,10,3,24,2468.0,9746.443,0.009608983993530273,0.002184152603149414,0.0,1253.5570000000007
191,07:22:00,1,1100,500,13,14,31,14,16,12,22,9,2,12,1387.0,5095.854734896091,0.0038881301879882812,0.0007350444793701172,0.0,4804.145265103909
194,15:17:30,0,1100,500,1,2,48,31,24,9,14,34,22,9,2381.9999999999927,10639.332000000002,0.07085704803466797,0.044905900955200195,1.9704106457378917e-09,26760.667999999998
198,19:44:00,0.2,1100,500,1,2,23,15,11,6,7,16,9,6,946.0,3955.6100000000006,0.009510040283203125,0.007028102874755859,0.0,13644.39
194,15:17:30,0.4,1100,500,9,10,48,25,22,13,24,24,12,13,2343.0,9398.907,0.010934114456176758,0.003061056137084961,0.0,17001.093
185,15:27:00,0,1100,500,1,2,26,29,19,12,11,15,17,12,2159.0,9285.613429912053,0.03567099571228027,0.03852200508117676,0.0,7214.387670088086
195,13:21:00,0.2,1100,500,4,5,40,40,25,20,21,19,20,20,2468.0,10616.565999999999,0.04244494438171387,0.26149702072143555,0.0,10283.434
194,07:10:00,0.2,1100,500,4,5,51,33,24,14,15,36,19,14,2372.0,10220.586,0.035654306411743164,0.0771479606628418,0.0,29379.414
55,15:58:00,0,1100,500,1,2,71,56,45,13,15,56,43,13,4074.0,18159.20628868304,0.32173585891723633,0.20299792289733887,0.0,43440.79438457891
199,13:24:30,0,1100,500,1,2,30,33,25,10,9,21,23,10,3030.0,13456.511999999999,0.05307602882385254,0.10183000564575195,0.0,9643.488000000001
196,09:57:30,1,1100,500,14,15,15,10,18,7,10,5,3,7,1956.0,7688.5470000000005,0.00234222412109375,0.0011157989501953125,0.0,-2188.5470000000005
185,07:21:00,1,1100,500,28,29,89,35,33,31,51,38,4,31,3435.0,13574.43,0.02334284782409668,0.0018780231475830078,0.0,28225.57
191,07:22:00,0.2,1100,500,2,3,31,24,15,12,19,12,12,12,1387.0,5757.66873489609,0.016933202743530273,0.05580782890319824,0.0,7442.33126510391
199,16:04:00,0.4,1100,500,8,9,43,27,22,14,19,24,13,14,3025.0,12900.685999999998,0.024038076400756836,0.06798195838928223,0.0,13499.314000000002
193,13:30:30,1,1100,500,14,15,48,22,16,21,34,14,1,21,1565.0,6125.9890000000005,0.01096200942993164,0.0014908313751220703,0.0,9274.010999999999
193,13:30:30,0.2,1100,500,3,4,48,30,16,18,29,19,12,18,1580.9895758768762,7001.405000000001,0.05385589599609375,0.029793977737426758,0.0,13898.595
199,13:24:30,0.2,1100,500,4,5,30,30,20,15,17,13,15,15,3030.0,11984.777999999998,0.013763666152954102,0.017293930053710938,0.0,2315.2220000000016
192,14:50:30,1,1100,500,14,15,53,30,22,23,38,15,7,23,2090.0,8393.471,0.014058351516723633,0.0023660659790039062,0.0,8106.529
187,16:47:00,0.4,1100,500,12,13,43,44,34,23,21,22,21,23,3338.0,14354.793,0.033535003662109375,0.013520956039428711,0.0,9845.207
187,13:47:00,1,1100,500,29,30,38,27,35,22,21,17,5,22,3294.0,12707.103000000003,0.009994983673095703,0.0011570453643798828,0.0,5992.896999999997
185,07:21:00,0.2,1100,500,5,6,89,54,40,20,28,61,34,20,3524.1275501073724,15555.145,0.11234211921691895,0.24801898002624512,0.0,51544.854999999996
191,13:41:30,0.4,1100,500,6,7,23,14,11,10,15,8,4,10,1381.0,5766.575684128705,0.005026102066040039,0.002270936965942383,0.0,3033.424315871295
187,13:47:00,0,1100,500,1,2,38,44,33,13,9,29,31,13,3294.0,14461.387999999999,0.11336302757263184,0.18380188941955566,0.0,17438.612
191,07:22:00,0.4,1100,500,5,6,31,21,14,13,21,10,8,13,1358.0,5423.882734896091,0.007796049118041992,0.004612922668457031,0.0,5576.117265103909
199,16:04:00,0.2,1100,500,4,5,43,30,21,14,16,27,16,14,3069.0,13207.301000000001,0.04098081588745117,0.09517598152160645,0.0,16492.699
195,13:21:00,0.4,1100,500,9,10,40,36,24,22,25,15,14,22,2468.0,9517.533,0.022268295288085938,0.021507978439331055,0.0,6982.467000000001
194,07:10:00,0.4,1100,500,9,10,51,29,25,14,18,33,15,14,2372.0,9920.453999999998,0.029299259185791016,0.07065606117248535,0.0,26379.546000000002
192,14:50:30,0,1100,500,1,2,53,40,21,21,24,29,19,21,2118.0,9385.818,0.12694406509399414,0.3003518581390381,0.0,22514.182
185,07:21:00,0,1100,500,1,2,89,58,40,20,25,64,38,20,3527.0,15636.57028049104,0.4276010990142822,0.19724702835083008,0.0,54763.43068678009
196,09:57:30,0,1100,500,1,2,15,18,17,3,2,13,15,3,1990.4809413027906,8898.246,0.010069131851196289,0.09608006477355957,0.0,5401.754000000001
193,13:30:30,0,1100,500,1,2,48,32,16,18,23,25,14,18,1589.0,7079.412000000001,0.0749361515045166,0.09009599685668945,0.0,20420.588
185,07:21:00,0.4,1100,500,11,12,89,48,38,22,34,55,26,22,3527.0,15337.58300000001,0.0711672306060791,0.09997892379760742,0.0,45162.417
191,13:41:30,0.2,1100,500,3,4,23,17,12,9,12,11,8,9,1422.0,6109.509684128758,0.008032083511352539,0.0046749114990234375,0.0,5990.490315871393
193,13:30:30,0.4,1100,500,6,7,48,28,17,18,30,18,10,18,1569.2321045096614,6737.3240000000005,0.021589040756225586,0.00775599479675293,0.0,13062.676
199,13:24:30,0.4,1100,500,8,9,30,27,21,15,17,13,12,15,3030.0,11984.777999999998,0.011624813079833984,0.010792970657348633,0.0,2315.2220000000016
199,13:24:30,1,1100,500,19,20,30,20,24,16,18,12,4,16,2990.0,12192.131999999998,0.005724906921386719,0.0014548301696777344,0.0,1007.8680000000022
187,16:47:00,0.2,1100,500,6,7,43,47,37,17,17,26,30,17,3338.0,14712.669,0.05820918083190918,0.02060389518737793,0.0,13887.331
55,15:58:00,1,1100,500,22,23,71,40,27,36,55,16,4,36,4074.0,15644.422000000002,0.0289459228515625,0.0022699832916259766,0.0,1955.5779999999977
187,16:47:00,1,1100,500,29,30,43,34,37,27,27,16,7,27,3294.0,13123.513999999997,0.012689828872680664,0.0015869140625,0.0,4476.486000000003
185,15:27:00,0.2,1100,500,3,4,26,27,17,14,13,13,13,14,2159.0,9252.3,0.016566038131713867,0.02247905731201172,0.0,5047.700000000001
192,08:28:00,0.4,1100,500,5,6,33,25,17,14,15,18,11,14,1976.0695687186817,8368.284,0.010349750518798828,0.01799488067626953,0.0,11431.716
55,18:56:00,1,1100,500,27,28,58,34,33,29,37,21,5,29,5139.0,19680.796000000002,0.016253232955932617,0.0027408599853515625,0.0,3419.203999999998
193,08:16:30,0.4,1100,500,5,6,43,25,16,15,22,21,10,15,1472.0,6100.402,0.016161203384399414,0.004140138626098633,0.0,16999.598
198,19:44:00,1,1100,500,7,8,23,9,10,7,11,12,2,7,946.0,3464.248,0.0020689964294433594,0.0010030269622802734,0.0,9735.752
155,13:50:00,1,1100,500,14,15,32,21,17,19,24,8,2,19,1607.0,6196.468000000001,0.005697965621948242,0.0011000633239746094,0.0,2603.5319999999992
187,13:47:00,0.2,1100,500,6,7,38,41,34,14,12,26,27,14,3338.0,14308.289999999999,0.03290128707885742,0.012413978576660156,0.0,14291.710000000001
196,16:23:30,0,1100,500,1,2,29,23,19,6,5,24,17,6,2060.0,8826.838999999998,0.025801897048950195,1.2026698589324951,0.0,17573.161
194,07:10:00,0,1100,500,1,2,51,36,25,13,14,37,23,13,2372.0,10407.921,0.09903693199157715,0.15784311294555664,0.0,30292.078999999998
192,08:28:00,1,1100,500,12,13,33,18,16,15,16,17,3,15,1966.275724767358,7896.714000000001,0.004969120025634766,0.0012879371643066406,0.0,10803.286
155,13:50:00,0.2,1100,500,3,4,32,26,16,14,17,15,12,14,1646.0,6856.992,0.01960611343383789,0.022680997848510742,0.0,9643.008
193,08:16:30,1,1100,500,13,14,43,18,14,18,32,11,0,18,1444.0,5418.034000000001,0.006333827972412109,0.0008828639984130859,0.0,6681.965999999999
196,16:23:30,1,1100,500,14,15,29,14,17,12,21,8,2,12,1954.0,7484.485000000001,0.004684925079345703,0.0011470317840576172,0.0,1315.5149999999994
155,13:50:00,0,1100,500,1,2,32,28,17,13,14,18,15,13,1646.0,7354.912999999999,0.03999519348144531,0.037561893463134766,0.0,12445.087000000001
193,08:16:30,0,1100,500,1,2,43,29,17,14,21,22,15,14,1472.0,6423.114,0.05736804008483887,0.039948225021362305,0.0,17776.886
192,08:28:00,0,1100,500,1,2,33,29,20,11,12,21,18,11,1991.0,8808.143,0.04468989372253418,0.13320183753967285,0.0,14291.857
194,07:10:00,1,1100,500,22,23,51,19,26,16,28,23,3,16,2334.0,8928.65,0.008723974227905273,0.001055002212524414,0.0,16371.35
198,19:44:00,0,1100,500,1,2,23,15,11,6,7,16,9,6,946.0,3955.6100000000006,0.009866952896118164,0.00739288330078125,0.0,13644.39
185,15:27:00,0.4,1100,500,7,8,26,25,18,15,17,9,10,15,2127.43450250537,8830.391999999996,0.008684158325195312,0.0032639503479003906,0.0,1069.6080000000038
192,08:28:00,0.2,1100,500,2,3,33,28,19,12,12,21,16,12,1991.0,8808.142999999935,0.02570486068725586,0.06345009803771973,0.0,14291.85700000002
187,13:47:00,0.4,1100,500,12,13,38,36,32,17,16,22,19,17,3338.0,13591.055999999997,0.021632671356201172,0.009996175765991211,0.0,10608.944000000003
55,18:56:00,0,1100,500,1,2,58,52,43,11,11,47,41,11,5139.0,22551.705451478436,0.2314929962158203,0.5677590370178223,0.0,29148.29535964273
155,13:50:00,0.4,1100,500,6,7,32,24,16,15,20,12,9,15,1607.0,6894.880999999999,0.01044607162475586,0.01645183563232422,0.0,6305.119000000001
193,08:16:30,0.2,1100,500,2,3,43,28,17,14,21,22,14,14,1472.0,6494.521999999999,0.03593087196350098,0.01587510108947754,0.0,17705.478000000003
187,16:47:00,0,1100,500,1,2,43,52,37,17,17,26,35,17,3338.0,14712.669,0.17581486701965332,1.3322489261627197,0.0,13887.331
